RBD;H_PROF;H_PARA;H_AUX;H_SIN_DATO;TOT_JORN
1;395;1058;357;0;1810
2;215;576;135;0;926
3;0;0;0;0;0
4;650;574;520;0;1744
5;423;1491;403;0;2317
7;678;1143;670;0;2491
8;425;1246;359;0;2030
9;1041;2534;446;0;4021
10;147;649;224;0;1020
11;450;1155;358;0;1963
12;234;571;313;0;1118
13;343;986;269;0;1598
14;260;495;134;0;889
15;482;1293;180;0;1955
16;434;1202;222;0;1858
17;354;712;180;0;1246
18;271;1103;268;0;1642
19;359;963;267;0;1589
20;423;1555;223;0;2201
21;0;0;0;0;0
22;785;2499;313;0;3597
25;494;1606;493;0;2593
26;224;547;261;0;1032
27;493;701;178;0;1372
28;532;1071;388;0;1991
29;700;1040;488;0;2228
30;143;916;313;0;1372
31;171;668;89;0;928
32;345;1489;402;0;2236
33;366;204;267;0;837
35;127;185;129;0;441
36;394;717;312;0;1423
38;515;568;223;0;1306
39;90;0;44;0;134
41;8;0;44;0;52
42;33;0;44;0;77
43;0;55;55;0;110
44;0;0;0;0;0
45;425;824;405;0;1654
46;0;44;0;0;44
47;0;0;0;0;0
49;55;63;45;0;163
50;215;613;180;0;1008
51;0;0;0;0;0
52;1743;1890;1530;0;5163
55;55;361;45;0;461
56;212;902;369;0;1483
57;0;0;0;0;0
58;36;90;27;0;153
59;243;437;132;0;812
60;214;1676;633;0;2523
65;0;0;0;0;0
66;12;58;33;0;103
67;90;135;180;0;405
69;0;230;135;0;365
70;0;44;0;0;44
72;0;220;88;0;308
73;0;0;0;0;0
74;0;0;0;0;0
75;0;0;0;0;0
76;0;0;0;0;0
78;226;397;309;0;932
79;0;88;74;0;162
81;0;44;0;0;44
82;0;0;0;0;0
83;0;44;0;0;44
84;0;0;0;0;0
86;0;44;44;0;88
87;0;0;0;0;0
88;0;0;0;0;0
89;0;0;0;0;0
90;0;132;44;0;176
91;0;0;0;0;0
92;0;0;0;0;0
93;0;0;0;0;0
94;0;0;0;0;0
95;0;0;0;0;0
97;186;440;619;0;1245
98;0;0;0;0;0
100;0;0;0;0;0
101;0;0;0;0;0
102;220;1522;310;0;2052
103;185;1039;176;0;1400
105;140;342;132;0;614
106;134;718;135;0;987
107;163;830;397;0;1390
108;156;613;575;0;1344
109;118;442;399;0;959
110;242;1771;529;0;2542
111;58;1157;353;0;1568
112;226;1617;396;0;2239
113;525;2138;706;0;3369
114;311;1328;440;0;2079
115;0;0;0;0;0
116;747;780;607;0;2134
117;360;1288;442;0;2090
119;182;1471;488;0;2141
120;0;0;0;0;0
122;242;1036;441;0;1719
123;162;1090;488;0;1740
124;473;660;752;0;1885
125;313;2105;748;0;3166
126;336;1891;575;0;2802
127;362;483;418;0;1263
128;0;0;0;0;0
129;0;180;45;0;225
130;85;0;135;0;220
131;201;135;88;0;424
132;260;1620;630;0;2510
133;211;979;315;0;1505
134;114;523;130;0;767
136;0;0;0;0;0
138;0;0;0;0;0
139;75;120;75;0;270
143;0;0;0;0;0
144;77;437;112;0;626
145;0;0;0;0;0
147;0;0;0;0;0
148;0;0;0;0;0
150;0;0;0;0;0
151;0;0;0;0;0
154;0;44;44;0;88
156;162;81;44;0;287
158;0;0;20;0;20
159;0;0;10;0;10
160;0;74;40;0;114
161;242;734;267;0;1243
162;0;0;15;0;15
165;0;0;15;0;15
167;44;44;88;0;176
168;0;0;0;0;0
169;0;0;0;0;0
170;0;0;0;0;0
171;0;0;0;0;0
172;0;0;0;0;0
173;0;0;0;0;0
174;0;0;0;0;0
175;0;0;0;0;0
177;10;44;0;0;54
178;122;132;88;0;342
179;0;0;44;0;44
184;0;0;0;0;0
185;0;0;0;0;0
186;0;0;44;0;44
187;165;858;265;0;1288
188;238;748;178;0;1164
191;546;1054;441;0;2041
192;61;88;44;0;193
193;504;1174;296;0;1974
195;237;478;132;0;847
196;17;0;79;0;96
198;62;132;44;0;238
199;449;602;739;0;1790
200;526;844;572;0;1942
201;627;1444;352;0;2423
203;446;1329;352;0;2127
204;359;1241;620;0;2220
205;455;926;396;0;1777
206;314;1082;468;0;1864
207;132;440;264;0;836
208;692;853;455;0;2000
209;0;0;0;0;0
210;240;1232;396;0;1868
211;84;418;220;0;722
214;0;44;44;0;88
217;53;440;450;0;943
218;88;266;360;0;714
219;88;514;495;0;1097
220;118;528;450;0;1096
222;88;346;315;0;749
223;14;352;404;0;770
224;328;220;934;0;1482
225;44;265;405;0;714
226;171;396;448;0;1015
227;218;352;315;0;885
228;51;88;225;0;364
229;67;132;315;0;514
230;286;308;505;0;1099
231;117;464;220;0;801
232;148;88;360;0;596
234;0;0;0;0;0
235;0;0;0;0;0
236;20;216;90;0;326
237;36;324;135;0;495
238;323;288;537;0;1148
239;242;585;357;0;1184
240;162;345;535;0;1042
241;149;72;234;0;455
243;0;0;45;0;45
244;136;144;315;0;595
245;0;144;90;0;234
246;0;0;45;0;45
248;0;0;45;0;45
249;0;0;0;0;0
251;0;0;0;0;0
252;92;0;45;0;137
253;302;994;225;0;1521
254;181;345;405;0;931
255;779;639;405;0;1823
256;450;978;1170;0;2598
257;580;270;747;0;1597
259;0;0;0;0;0
261;0;0;0;0;0
262;324;44;45;0;413
265;0;0;234;0;234
268;0;44;0;0;44
269;388;1111;308;0;1807
270;221;253;176;0;650
271;0;0;44;0;44
273;0;0;44;0;44
274;44;0;88;0;132
275;0;0;22;0;22
276;0;0;44;0;44
277;28;0;44;0;72
279;658;1540;792;0;2990
280;376;792;704;0;1872
282;0;0;0;0;0
283;460;1188;660;0;2308
284;484;1390;528;0;2402
285;580;1248;704;0;2532
286;230;748;528;0;1506
287;590;920;614;0;2124
288;402;1100;88;0;1590
289;534;698;518;0;1750
291;428;1006;396;0;1830
292;494;921;440;0;1855
293;1012;1123;660;0;2795
294;308;704;396;0;1408
296;441;694;528;0;1663
297;410;976;570;0;1956
298;303;560;440;0;1303
299;0;0;0;0;0
301;264;484;396;0;1144
302;352;493;500;0;1345
303;308;484;396;0;1188
304;754;1332;660;0;2746
305;572;698;752;0;2022
306;255;736;176;0;1167
307;238;441;221;0;900
308;0;0;0;0;0
310;266;739;516;0;1521
311;220;910;220;0;1350
312;365;887;484;0;1736
313;493;1044;528;0;2065
315;190;478;440;0;1108
316;308;610;396;0;1314
317;264;1471;528;0;2263
318;34;324;88;0;446
319;440;748;574;0;1762
320;308;922;396;0;1626
321;0;0;0;0;0
322;405;820;396;0;1621
324;202;761;396;0;1359
326;308;699;528;0;1535
327;0;0;0;0;0
329;245;677;408;0;1330
330;141;242;220;0;603
332;323;440;748;0;1511
333;240;440;220;0;900
335;489;499;270;0;1258
336;65;1145;315;0;1525
337;170;595;225;0;990
340;92;207;45;0;344
341;278;854;270;0;1402
342;540;1007;675;0;2222
343;270;433;225;0;928
344;135;290;180;0;605
349;0;178;0;0;178
350;113;360;360;0;833
352;0;0;0;0;0
353;0;0;0;0;0
354;0;0;0;0;0
355;0;0;0;0;0
356;0;1036;360;0;1396
357;0;45;0;0;45
358;88;288;0;0;376
361;118;637;0;0;755
363;0;0;0;0;0
364;99;633;336;0;1068
365;117;485;270;0;872
366;255;815;495;0;1565
367;798;968;528;0;2294
368;484;1125;352;0;1961
369;10;44;30;0;84
370;176;308;176;0;660
371;132;132;132;0;396
372;396;748;352;0;1496
373;308;660;264;0;1232
374;506;1276;308;0;2090
375;440;1423;352;0;2215
377;0;88;44;0;132
378;0;0;0;0;0
379;202;924;264;0;1390
380;362;340;470;0;1172
381;102;280;44;0;426
382;374;241;132;0;747
383;122;504;221;0;847
384;259;792;440;0;1491
385;0;0;0;0;0
386;220;1197;308;0;1725
387;10;44;44;0;98
388;0;0;0;0;0
389;0;0;0;0;0
390;224;675;495;0;1394
391;0;0;0;0;0
392;235;540;45;0;820
396;361;646;308;0;1315
397;0;132;0;0;132
399;485;678;396;0;1559
400;156;954;0;0;1110
401;588;1187;308;0;2083
402;0;0;0;0;0
403;480;876;396;0;1752
404;294;792;132;0;1218
405;672;1088;352;0;2112
406;511;1046;176;0;1733
407;543;676;132;0;1351
408;870;1703;440;0;3013
410;116;897;308;0;1321
411;451;677;220;0;1348
413;220;514;220;0;954
415;176;1086;440;0;1702
416;352;944;308;0;1604
417;556;808;352;0;1716
418;845;1526;220;0;2591
419;452;1636;440;0;2528
420;332;907;88;0;1327
421;483;895;299;0;1677
423;236;220;176;0;632
427;263;716;176;0;1155
429;923;1391;965;0;3279
430;300;1782;424;0;2506
431;577;738;310;0;1625
433;418;932;270;0;1620
434;362;1047;254;0;1663
435;0;0;0;0;0
437;210;836;352;0;1398
438;158;488;264;0;910
439;0;0;44;0;44
440;448;1530;585;0;2563
441;374;425;176;0;975
442;378;625;176;0;1179
444;587;622;264;0;1473
445;44;30;30;0;104
446;0;0;0;0;0
447;0;0;0;0;0
448;388;1074;484;0;1946
449;528;954;440;0;1922
450;138;520;264;0;922
452;173;783;176;0;1132
453;146;1078;396;0;1620
454;404;1354;520;0;2278
455;310;591;176;0;1077
456;198;396;176;0;770
458;351;646;308;0;1305
459;470;1178;480;0;2128
461;184;750;308;0;1242
462;140;304;716;0;1160
463;0;316;132;0;448
464;220;1207;528;0;1955
466;0;0;0;0;0
467;0;0;88;0;88
468;0;40;22;0;62
469;54;44;44;0;142
471;0;117;44;0;161
472;0;0;0;0;0
475;0;0;0;0;0
476;48;126;30;0;204
477;0;0;0;0;0
478;180;907;490;0;1577
479;90;771;243;0;1104
480;0;0;0;0;0
481;264;1209;176;0;1649
482;0;84;40;0;124
483;0;132;44;0;176
484;64;76;44;0;184
485;0;0;66;0;66
486;336;1008;220;0;1564
487;326;1022;334;0;1682
489;207;855;157;0;1219
490;30;30;44;0;104
492;84;228;90;0;402
493;31;660;132;0;823
495;15;44;0;0;59
496;15;66;0;0;81
497;0;0;0;0;0
498;0;0;0;0;0
499;85;522;264;0;871
500;0;22;0;0;22
501;0;0;0;0;0
502;0;0;0;0;0
503;0;0;0;0;0
504;0;0;0;0;0
505;0;0;0;0;0
506;0;0;0;0;0
508;0;0;0;0;0
509;0;0;0;0;0
511;0;0;0;0;0
512;0;0;0;0;0
513;0;0;0;0;0
514;17;0;0;0;17
515;0;0;0;0;0
516;260;740;309;0;1309
517;222;616;308;0;1146
518;315;484;308;0;1107
519;541;1258;308;0;2107
520;0;0;0;0;0
521;340;546;220;0;1106
522;264;636;352;0;1252
523;159;628;220;0;1007
525;321;352;414;0;1087
526;229;448;352;0;1029
527;187;776;220;0;1183
528;326;538;220;0;1084
529;211;700;176;0;1087
530;325;1188;484;0;1997
531;280;519;344;0;1143
532;320;516;192;0;1028
533;170;152;88;0;410
534;352;470;514;0;1336
535;317;522;352;0;1191
536;205;365;352;0;922
537;81;456;88;0;625
539;141;132;132;0;405
540;169;120;126;0;415
542;109;348;176;0;633
543;144;278;88;0;510
544;247;100;62;0;409
546;96;44;264;0;404
548;185;262;88;0;535
549;0;0;64;0;64
550;0;0;20;0;20
551;104;88;132;0;324
552;0;0;20;0;20
553;0;0;0;0;0
554;4;0;20;0;24
556;174;321;176;0;671
557;135;402;88;0;625
558;6;0;10;0;16
559;0;0;0;0;0
560;96;288;132;0;516
561;0;88;20;0;108
562;172;260;132;0;564
563;0;0;0;0;0
564;0;0;30;0;30
565;366;992;630;0;1988
566;92;550;120;0;762
567;257;1160;535;0;1952
568;148;576;90;0;814
570;105;468;413;0;986
571;63;95;30;0;188
573;118;264;324;0;706
574;242;639;585;0;1466
575;123;585;495;0;1203
577;0;0;0;0;0
578;201;528;264;0;993
579;436;416;393;0;1245
580;260;540;315;0;1115
581;88;740;221;0;1049
582;160;662;265;0;1087
583;267;576;930;0;1773
584;0;0;0;0;0
585;792;635;630;0;2057
587;0;0;0;0;0
589;50;366;75;0;491
590;255;315;450;0;1020
591;0;0;0;0;0
592;0;0;0;0;0
594;0;62;40;0;102
597;142;334;176;0;652
598;0;0;44;0;44
599;80;306;88;0;474
600;0;0;0;0;0
601;0;0;0;0;0
602;166;278;132;0;576
604;66;0;44;0;110
606;0;0;0;0;0
607;0;0;0;0;0
608;0;0;44;0;44
609;255;880;528;0;1663
610;304;836;264;0;1404
611;334;666;176;0;1176
612;230;462;88;0;780
613;346;945;338;0;1629
614;141;792;132;0;1065
615;234;554;132;0;920
616;365;1422;352;0;2139
617;241;352;396;0;989
618;491;1220;484;0;2195
620;152;940;88;0;1180
621;235;510;220;0;965
623;80;88;308;0;476
624;114;654;0;0;768
625;211;1075;440;0;1726
626;342;1060;308;0;1710
628;174;634;88;0;896
629;323;660;352;0;1335
630;207;656;132;0;995
631;263;846;88;0;1197
632;264;725;176;0;1165
634;68;82;44;0;194
635;5;44;88;0;137
637;196;264;352;0;812
638;0;0;44;0;44
639;49;0;88;0;137
640;0;0;0;0;0
641;19;0;44;0;63
642;80;40;132;0;252
643;71;250;74;0;395
644;6;108;0;0;114
645;0;0;44;0;44
646;376;909;495;0;1780
647;140;110;250;0;500
648;268;681;783;0;1732
649;190;1512;450;0;2152
650;183;379;288;0;850
654;0;0;0;0;0
655;125;240;90;0;455
656;211;666;176;0;1053
657;225;377;132;0;734
658;87;713;176;0;976
659;5;2;44;0;51
660;0;0;0;0;0
661;8;2;44;0;54
662;10;46;0;0;56
663;0;0;0;0;0
664;331;885;315;0;1531
665;135;578;308;0;1021
666;146;374;294;0;814
668;116;606;132;0;854
669;200;162;88;0;450
671;70;164;88;0;322
672;103;158;88;0;349
673;108;242;132;0;482
674;0;0;0;0;0
675;0;0;0;0;0
676;0;0;44;0;44
678;15;84;88;0;187
680;56;118;0;0;174
681;5;30;44;0;79
682;76;172;88;0;336
683;10;0;88;0;98
685;0;0;0;0;0
686;18;164;44;0;226
687;0;0;44;0;44
688;4;74;0;0;78
689;0;0;44;0;44
690;220;596;443;0;1259
691;82;340;132;0;554
692;12;376;132;0;520
693;21;0;44;0;65
694;57;220;88;0;365
695;21;126;44;0;191
696;7;38;38;0;83
697;9;0;60;0;69
699;38;38;22;0;98
701;446;616;572;0;1634
704;396;1100;881;0;2377
705;229;1232;859;0;2320
706;319;734;691;0;1744
707;282;817;441;0;1540
708;262;562;355;0;1179
709;192;446;445;0;1083
710;187;620;355;0;1162
711;382;776;354;0;1512
712;156;1056;355;0;1567
713;82;490;311;0;883
714;226;748;586;0;1560
715;165;529;177;0;871
716;438;565;285;0;1288
718;128;140;222;0;490
719;162;572;220;0;954
721;190;920;400;0;1510
722;245;88;530;0;863
723;8;44;65;0;117
724;0;0;0;0;0
725;115;352;88;0;555
726;0;0;0;0;0
727;0;0;0;0;0
728;0;0;20;0;20
729;42;44;132;0;218
730;133;88;362;0;583
731;185;66;88;0;339
732;0;0;0;0;0
733;18;0;212;0;230
735;0;0;0;0;0
736;0;0;0;0;0
737;107;355;132;0;594
738;0;0;0;0;0
739;0;0;0;0;0
740;37;176;88;0;301
741;0;0;0;0;0
743;21;0;132;0;153
744;0;0;66;0;66
745;0;0;0;0;0
746;0;0;0;0;0
747;73;132;177;0;382
749;0;0;0;0;0
750;121;76;163;0;360
752;0;0;0;0;0
753;81;354;44;0;479
754;8;0;64;0;72
755;0;0;0;0;0
756;3;0;22;0;25
757;49;220;88;0;357
758;0;0;0;0;0
759;0;0;88;0;88
760;0;0;22;0;22
761;0;0;0;0;0
762;0;0;0;0;0
763;168;1463;616;0;2247
766;405;1641;785;0;2831
767;0;406;90;0;496
768;241;815;608;0;1664
769;276;501;590;0;1367
770;74;503;360;0;937
771;0;0;10;0;10
772;90;540;540;0;1170
773;58;254;44;0;356
774;236;524;264;0;1024
775;52;44;4;0;100
776;44;0;0;0;44
777;63;0;30;0;93
778;21;38;0;0;59
780;24;44;0;0;68
783;0;0;44;0;44
784;10;0;0;0;10
785;4;0;0;0;4
786;3;0;0;0;3
787;3;0;0;0;3
788;8;0;0;0;8
789;7;0;0;0;7
790;16;0;0;0;16
791;0;0;0;0;0
792;5;0;0;0;5
793;43;56;0;0;99
795;0;0;44;0;44
797;13;0;0;0;13
798;845;1100;440;0;2385
799;465;968;484;0;1917
800;127;479;88;0;694
802;484;968;440;0;1892
803;249;396;264;0;909
804;176;282;253;0;711
805;0;44;0;0;44
806;0;0;0;0;0
807;0;0;0;0;0
808;0;0;0;0;0
809;0;0;44;0;44
810;0;0;0;0;0
811;0;0;0;0;0
812;3;0;30;0;33
813;0;0;20;0;20
814;0;30;0;0;30
816;0;0;0;0;0
817;0;16;22;0;38
818;0;0;0;0;0
819;0;38;0;0;38
820;0;34;0;0;34
821;123;224;132;0;479
822;74;126;82;0;282
823;0;0;22;0;22
824;0;0;0;0;0
825;0;0;25;0;25
826;0;0;0;0;0
827;190;220;352;0;762
828;0;0;0;0;0
830;27;34;0;0;61
831;0;0;0;0;0
833;76;220;118;0;414
834;0;0;0;0;0
835;0;0;22;0;22
836;0;0;0;0;0
837;107;44;118;0;269
838;89;44;30;0;163
839;83;44;44;0;171
840;0;0;0;0;0
841;0;0;0;0;0
842;0;0;0;0;0
843;0;0;0;0;0
844;0;55;0;0;55
845;277;735;352;0;1364
847;189;1416;506;0;2111
848;334;850;176;0;1360
849;49;194;132;0;375
850;0;0;44;0;44
851;73;202;44;0;319
852;37;308;113;0;458
853;0;0;0;0;0
854;0;0;0;0;0
856;0;0;0;0;0
857;14;56;25;0;95
859;0;0;0;0;0
861;0;0;0;0;0
862;10;0;0;0;10
864;0;0;0;0;0
865;9;44;0;0;53
866;0;0;0;0;0
867;0;0;0;0;0
868;9;0;36;0;45
869;8;0;0;0;8
870;13;35;0;0;48
871;60;0;44;0;104
872;0;0;0;0;0
874;0;0;0;0;0
875;0;0;0;0;0
876;70;180;44;0;294
878;0;0;0;0;0
879;9;0;0;0;9
881;0;0;0;0;0
882;0;0;0;0;0
883;0;30;0;0;30
884;0;0;0;0;0
885;0;0;0;0;0
886;0;0;0;0;0
887;8;0;0;0;8
888;9;0;44;0;53
889;0;0;0;0;0
890;0;0;0;0;0
891;0;0;20;0;20
892;8;38;38;0;84
893;0;0;0;0;0
896;0;0;0;0;0
897;369;1236;220;0;1825
898;0;0;0;0;0
899;2;0;0;0;2
900;9;44;44;0;97
901;0;0;0;0;0
902;0;0;0;0;0
904;0;0;0;0;0
905;25;132;176;0;333
906;0;0;0;0;0
907;6;26;22;0;54
908;33;30;178;0;241
909;0;0;0;0;0
910;28;44;44;0;116
911;0;0;0;0;0
912;0;0;0;0;0
914;0;0;10;0;10
915;30;104;118;0;252
916;0;0;0;0;0
917;0;0;0;0;0
919;0;0;0;0;0
920;0;0;0;0;0
921;0;0;0;0;0
922;0;0;0;0;0
923;0;0;0;0;0
924;30;44;133;0;207
925;7;38;44;0;89
926;0;0;0;0;0
928;6;0;22;0;28
929;99;88;44;0;231
931;8;22;44;0;74
932;97;177;178;0;452
933;2;0;22;0;24
934;5;0;44;0;49
935;35;0;22;0;57
936;0;0;0;0;0
937;77;132;88;0;297
939;0;0;22;0;22
940;0;0;44;0;44
941;0;0;0;0;0
942;0;0;0;0;0
943;0;0;30;0;30
945;18;104;66;0;188
946;139;306;214;0;659
947;41;308;178;0;527
948;0;0;0;0;0
949;12;0;22;0;34
950;0;0;0;0;0
951;0;0;0;0;0
952;0;0;0;0;0
953;43;88;110;0;241
954;8;0;44;0;52
955;6;0;22;0;28
956;5;0;44;0;49
957;5;0;22;0;27
959;126;810;90;0;1026
960;0;0;45;0;45
962;0;0;0;0;0
963;0;0;0;0;0
964;88;272;88;0;448
967;219;660;396;0;1275
968;426;968;572;0;1966
969;416;1165;352;0;1933
970;86;338;264;0;688
971;242;836;264;0;1342
972;232;656;132;0;1020
973;196;246;112;0;554
974;39;84;44;0;167
976;75;132;110;0;317
977;115;76;44;0;235
978;0;0;22;0;22
979;0;0;0;0;0
981;0;56;0;0;56
982;280;812;264;0;1356
983;0;0;0;0;0
984;0;0;22;0;22
985;48;5;22;0;75
986;0;0;22;0;22
987;89;1262;730;0;2081
988;244;359;135;0;738
990;67;219;68;0;354
991;0;0;40;0;40
993;0;0;52;0;52
994;0;45;15;0;60
995;0;0;60;0;60
996;0;0;11;0;11
997;0;0;0;0;0
998;0;0;0;0;0
999;36;0;10;0;46
1000;0;0;0;0;0
1001;0;34;0;0;34
1002;0;0;20;0;20
1003;0;0;20;0;20
1004;0;38;17;0;55
1005;0;0;20;0;20
1006;12;101;45;0;158
1007;0;0;0;0;0
1008;0;0;10;0;10
1010;0;0;11;0;11
1011;11;0;0;0;11
1013;108;923;60;0;1091
1014;124;706;132;0;962
1015;124;175;78;0;377
1016;27;156;44;0;227
1017;72;158;44;0;274
1018;33;252;44;0;329
1019;66;69;218;0;353
1020;150;168;0;0;318
1021;0;3;0;0;3
1022;8;106;44;0;158
1023;0;0;0;0;0
1024;0;0;0;0;0
1025;0;0;0;0;0
1027;0;0;44;0;44
1028;0;0;0;0;0
1029;0;0;0;0;0
1030;0;0;44;0;44
1031;48;88;88;0;224
1032;0;0;44;0;44
1033;36;188;0;0;224
1034;8;44;44;0;96
1036;255;946;449;0;1650
1037;20;40;10;0;70
1038;0;0;0;0;0
1039;0;0;0;0;0
1040;0;0;20;0;20
1041;0;60;50;0;110
1042;0;47;44;0;91
1044;0;0;22;0;22
1045;0;38;11;0;49
1046;0;0;20;0;20
1047;0;45;10;0;55
1048;132;528;440;0;1100
1049;481;902;264;0;1647
1050;98;396;176;0;670
1051;88;554;242;0;884
1052;98;220;88;0;406
1053;18;82;44;0;144
1054;0;0;0;0;0
1055;18;132;0;0;150
1059;58;220;172;0;450
1061;18;22;0;0;40
1062;0;0;0;0;0
1063;53;0;0;0;53
1064;0;0;0;0;0
1065;0;0;0;0;0
1066;216;600;320;0;1136
1067;0;0;0;0;0
1068;0;0;11;0;11
1069;0;22;0;0;22
1070;0;0;12;0;12
1071;0;0;11;0;11
1072;0;44;12;0;56
1073;0;0;12;0;12
1075;0;0;0;0;0
1076;0;12;0;0;12
1077;203;628;176;0;1007
1078;95;154;69;0;318
1079;0;0;0;0;0
1080;0;0;12;0;12
1081;0;0;12;0;12
1082;0;0;12;0;12
1083;0;0;12;0;12
1084;0;0;12;0;12
1085;0;0;12;0;12
1086;0;0;0;0;0
1087;146;684;132;0;962
1089;0;0;0;0;0
1090;0;0;12;0;12
1092;0;74;44;0;118
1093;0;0;12;0;12
1094;0;0;12;0;12
1095;0;0;12;0;12
1096;0;44;22;0;66
1097;0;0;0;0;0
1098;0;0;0;0;0
1099;16;36;36;0;88
1100;100;110;44;0;254
1101;0;0;12;0;12
1102;0;0;12;0;12
1103;0;0;0;0;0
1104;0;0;12;0;12
1105;0;0;0;0;0
1106;0;0;0;0;0
1108;0;0;0;0;0
1109;0;0;24;0;24
1112;0;0;0;0;0
1113;0;0;0;0;0
1114;0;0;10;0;10
1115;0;0;0;0;0
1116;0;0;34;0;34
1117;0;0;15;0;15
1119;242;693;314;0;1249
1120;44;0;28;0;72
1121;176;801;412;0;1389
1122;134;625;132;0;891
1123;159;906;298;0;1363
1125;152;88;264;0;504
1126;12;202;44;0;258
1128;168;482;88;0;738
1129;0;30;15;0;45
1130;0;0;15;0;15
1131;0;60;15;0;75
1132;29;185;44;0;258
1133;4;72;20;0;96
1134;0;39;15;0;54
1135;0;0;22;0;22
1136;5;58;32;0;95
1137;0;44;15;0;59
1139;9;166;22;0;197
1140;0;38;42;0;80
1142;15;100;22;0;137
1143;4;38;30;0;72
1144;0;34;22;0;56
1145;4;40;44;0;88
1147;43;312;45;0;400
1148;200;384;223;0;807
1149;128;329;177;0;634
1150;4;74;25;0;103
1151;0;0;20;0;20
1152;207;0;75;0;282
1153;0;20;0;0;20
1154;0;0;0;0;0
1156;21;25;0;0;46
1157;28;33;22;0;83
1158;0;0;0;0;0
1160;3;0;0;0;3
1161;124;170;74;0;368
1162;0;0;45;0;45
1164;58;633;225;0;916
1166;74;250;44;0;368
1167;208;264;234;0;706
1168;317;807;176;0;1300
1170;137;264;120;0;521
1171;0;58;11;0;69
1173;0;0;149;0;149
1174;54;130;42;0;226
1175;0;0;0;0;0
1176;0;176;44;0;220
1177;0;0;0;0;0
1178;0;234;98;0;332
1179;0;0;0;0;0
1180;198;350;120;0;668
1181;0;74;11;0;85
1182;0;15;33;0;48
1183;211;404;270;0;885
1184;204;585;135;0;924
1185;164;339;90;0;593
1187;0;0;0;0;0
1189;200;180;202;0;582
1190;55;159;270;0;484
1191;127;472;180;0;779
1192;42;475;180;0;697
1194;339;1054;396;0;1789
1195;45;270;180;0;495
1196;186;570;55;0;811
1197;275;924;748;0;1947
1198;111;528;231;0;870
1199;151;283;319;0;753
1200;199;478;88;0;765
1201;83;405;132;0;620
1202;143;681;88;0;912
1203;155;648;176;0;979
1204;94;222;176;0;492
1206;196;88;199;0;483
1208;19;82;176;0;277
1210;100;192;88;0;380
1211;238;665;156;0;1059
1212;132;78;88;0;298
1213;573;2157;990;0;3720
1214;232;337;428;0;997
1215;107;565;225;0;897
1216;20;315;90;0;425
1217;52;654;438;0;1144
1218;120;446;90;0;656
1220;78;552;180;0;810
1221;150;129;90;0;369
1225;0;0;0;0;0
1226;45;75;78;0;198
1228;0;0;0;0;0
1229;44;65;45;0;154
1230;0;0;0;0;0
1233;137;681;182;0;1000
1234;162;245;164;0;571
1235;110;209;120;0;439
1237;0;2;44;0;46
1238;49;79;196;0;324
1239;0;0;22;0;22
1240;21;86;44;0;151
1243;19;29;88;0;136
1244;0;3;44;0;47
1245;52;211;88;0;351
1246;82;108;201;0;391
1247;75;71;88;0;234
1248;203;363;132;0;698
1249;47;76;44;0;167
1250;53;117;0;0;170
1251;68;168;162;0;398
1252;59;47;44;0;150
1254;0;0;0;0;0
1255;91;542;720;0;1353
1256;199;196;256;0;651
1257;266;467;637;0;1370
1258;98;128;232;0;458
1259;84;132;162;0;378
1260;125;815;135;0;1075
1261;52;650;396;0;1098
1262;365;343;405;0;1113
1263;388;959;704;0;2051
1264;209;346;396;0;951
1265;343;470;132;0;945
1266;107;409;132;0;648
1268;450;1770;484;0;2704
1269;180;352;44;0;576
1271;275;696;250;0;1221
1273;183;71;44;0;298
1274;164;578;88;0;830
1275;345;828;308;0;1481
1276;209;765;182;0;1156
1277;0;0;0;0;0
1279;74;258;176;0;508
1280;289;544;88;0;921
1281;116;209;44;0;369
1282;119;134;132;0;385
1283;124;230;132;0;486
1285;97;132;132;0;361
1286;75;88;176;0;339
1287;215;288;148;0;651
1288;114;1020;270;0;1404
1289;40;269;90;0;399
1290;59;482;255;0;796
1291;0;90;290;0;380
1292;122;37;90;0;249
1294;0;240;270;0;510
1296;0;0;0;0;0
1297;0;0;0;0;0
1299;0;0;0;0;0
1300;45;495;630;0;1170
1301;209;604;198;0;1011
1302;96;603;89;0;788
1304;26;40;88;0;154
1305;52;218;133;0;403
1306;0;0;0;0;0
1307;85;118;126;0;329
1308;8;80;0;0;88
1309;52;70;44;0;166
1310;17;126;138;0;281
1311;102;296;165;0;563
1312;25;116;44;0;185
1313;18;185;44;0;247
1314;0;0;0;0;0
1315;0;0;0;0;0
1316;104;597;474;0;1175
1318;77;494;220;0;791
1319;36;220;44;0;300
1321;53;291;44;0;388
1322;59;0;44;0;103
1323;34;146;44;0;224
1325;64;35;88;0;187
1326;47;71;44;0;162
1327;304;822;405;0;1531
1328;52;234;90;0;376
1329;69;366;45;0;480
1330;0;0;0;0;0
1331;73;191;90;0;354
1332;42;232;45;0;319
1333;29;135;90;0;254
1335;144;528;352;0;1024
1336;116;582;510;0;1208
1337;179;338;88;0;605
1338;80;382;176;0;638
1339;179;316;176;0;671
1340;138;241;132;0;511
1341;98;308;132;0;538
1342;18;88;88;0;194
1343;53;88;88;0;229
1344;0;0;0;0;0
1345;32;220;88;0;340
1346;66;88;176;0;330
1347;151;576;527;0;1254
1349;108;120;443;0;671
1350;66;229;457;0;752
1352;134;788;352;0;1274
1353;66;280;88;0;434
1354;159;308;220;0;687
1355;81;134;132;0;347
1356;41;36;44;0;121
1357;0;0;0;0;0
1358;34;88;88;0;210
1359;40;160;88;0;288
1360;19;88;164;0;271
1361;245;855;225;0;1325
1362;83;90;630;0;803
1363;400;1056;352;0;1808
1364;157;833;308;0;1298
1366;176;616;220;0;1012
1367;168;292;264;0;724
1368;174;951;264;0;1389
1369;240;610;176;0;1026
1370;204;480;220;0;904
1371;292;707;308;0;1307
1373;0;0;0;0;0
1374;133;314;132;0;579
1375;0;0;0;0;0
1376;0;0;0;0;0
1377;202;608;132;0;942
1378;195;258;132;0;585
1383;0;0;0;0;0
1384;210;333;132;0;675
1385;160;246;172;0;578
1386;0;0;0;0;0
1387;0;0;0;0;0
1388;0;0;0;0;0
1389;84;132;88;0;304
1390;50;158;88;0;296
1391;127;30;45;0;202
1392;40;360;225;0;625
1393;124;280;225;0;629
1394;16;256;203;0;475
1395;272;885;445;0;1602
1397;457;1261;402;0;2120
1400;68;120;45;0;233
1402;23;108;0;0;131
1403;0;0;0;0;0
1404;180;1288;790;0;2258
1405;665;585;225;0;1475
1406;0;0;0;0;0
1408;0;0;0;0;0
1409;0;0;0;0;0
1412;0;0;0;0;0
1413;0;0;0;0;0
1414;24;0;132;0;156
1416;76;0;220;0;296
1417;60;44;88;0;192
1418;32;44;0;0;76
1419;60;0;88;0;148
1421;100;238;180;0;518
1422;164;270;176;0;610
1423;252;189;260;0;701
1424;160;461;88;0;709
1425;102;624;264;0;990
1426;0;0;0;0;0
1427;133;376;132;0;641
1428;203;290;278;0;771
1430;108;330;132;0;570
1431;268;334;208;0;810
1433;167;296;88;0;551
1434;0;0;0;0;0
1435;49;220;132;0;401
1436;60;508;360;0;928
1437;179;457;280;0;916
1438;0;340;45;0;385
1440;0;0;0;0;0
1441;0;0;0;0;0
1442;0;295;115;0;410
1443;294;396;264;0;954
1444;112;289;309;0;710
1445;183;294;485;0;962
1447;149;291;176;0;616
1448;94;52;88;0;234
1449;378;350;624;0;1352
1450;162;499;323;0;984
1452;0;0;0;0;0
1453;425;544;313;0;1282
1454;178;179;88;0;445
1455;265;371;89;0;725
1456;180;134;107;0;421
1457;266;130;44;0;440
1458;182;125;134;0;441
1459;107;301;89;0;497
1460;222;0;44;0;266
1461;63;275;74;0;412
1462;222;44;44;0;310
1464;284;596;250;0;1130
1465;115;570;370;0;1055
1466;131;434;176;0;741
1467;378;348;248;0;974
1468;63;388;132;0;583
1469;289;424;220;0;933
1470;0;0;0;0;0
1471;36;74;132;0;242
1472;155;82;214;0;451
1473;80;44;44;0;168
1474;147;344;177;0;668
1475;9;0;44;0;53
1476;0;0;0;0;0
1478;115;495;270;0;880
1479;59;166;45;0;270
1481;0;0;0;0;0
1482;53;285;279;0;617
1483;404;109;256;0;769
1484;266;386;314;0;966
1485;0;0;0;0;0
1488;177;572;44;0;793
1489;54;216;115;0;385
1490;49;188;133;0;370
1491;126;340;193;0;659
1492;0;0;0;0;0
1493;34;0;44;0;78
1495;14;0;44;0;58
1496;33;132;44;0;209
1497;0;0;0;0;0
1498;23;45;88;0;156
1500;247;855;360;0;1462
1502;236;1260;528;0;2024
1503;133;821;397;0;1351
1504;405;1468;926;0;2799
1506;205;465;176;0;846
1507;47;44;0;0;91
1508;169;220;525;0;914
1509;63;44;170;0;277
1510;184;44;88;0;316
1511;132;308;220;0;660
1514;243;176;286;0;705
1515;317;1161;396;0;1874
1516;473;998;507;0;1978
1517;261;676;308;0;1245
1518;274;1012;398;0;1684
1519;68;396;374;0;838
1520;304;328;311;0;943
1521;184;964;485;0;1633
1522;183;475;272;0;930
1523;218;1192;406;0;1816
1524;99;370;134;0;603
1525;797;530;487;0;1814
1526;275;468;178;0;921
1528;144;731;371;0;1246
1529;204;290;405;0;899
1533;528;1145;485;0;2158
1534;352;1218;616;0;2186
1535;0;0;0;0;0
1536;374;1029;280;0;1683
1537;118;931;396;0;1445
1538;71;198;222;0;491
1540;70;132;154;0;356
1541;249;340;365;0;954
1542;418;176;1097;0;1691
1543;108;384;357;0;849
1545;0;0;0;0;0
1547;145;448;133;0;726
1548;199;271;129;0;599
1549;450;682;285;0;1417
1550;69;228;111;0;408
1551;148;476;337;0;961
1552;0;0;0;0;0
1553;332;579;619;0;1530
1554;308;69;176;0;553
1555;159;246;178;0;583
1556;142;132;88;0;362
1557;52;308;218;0;578
1559;0;0;0;0;0
1560;0;0;0;0;0
1563;89;44;88;0;221
1567;46;132;133;0;311
1568;219;245;216;0;680
1569;123;377;352;0;852
1570;198;524;277;0;999
1571;90;80;110;0;280
1573;115;224;265;0;604
1577;203;396;199;0;798
1578;107;126;114;0;347
1579;75;322;179;0;576
1580;112;93;180;0;385
1581;232;575;611;0;1418
1582;105;495;327;0;927
1583;328;30;150;0;508
1584;149;0;44;0;193
1585;350;262;470;0;1082
1586;125;540;449;0;1114
1587;250;291;500;0;1041
1588;100;376;193;0;669
1590;498;502;630;0;1630
1593;235;597;341;0;1173
1594;150;522;315;0;987
1595;233;342;270;0;845
1596;275;340;580;0;1195
1597;117;215;45;0;377
1598;252;278;90;0;620
1599;174;88;255;0;517
1600;0;0;0;0;0
1601;327;0;434;0;761
1602;126;94;85;0;305
1603;55;238;135;0;428
1604;498;837;442;0;1777
1606;0;0;0;0;0
1607;212;450;180;0;842
1609;257;183;225;0;665
1610;85;489;225;0;799
1614;0;0;0;0;0
1616;0;0;0;0;0
1617;0;0;0;0;0
1618;0;0;0;0;0
1619;282;144;115;0;541
1620;80;0;300;0;380
1621;0;113;120;0;233
1623;0;0;0;0;0
1624;0;0;0;0;0
1626;0;0;0;0;0
1629;0;0;0;0;0
1631;414;169;2829;0;3412
1632;0;364;215;0;579
1634;0;0;0;0;0
1635;227;45;225;0;497
1637;0;0;0;0;0
1638;0;0;0;0;0
1641;670;180;675;0;1525
1643;0;0;0;0;0
1644;0;0;0;0;0
1646;0;0;0;0;0
1647;0;0;0;0;0
1648;0;0;0;0;0
1650;0;30;40;0;70
1653;40;167;307;0;514
1654;0;0;0;0;0
1657;60;142;105;0;307
1658;0;0;0;0;0
1660;0;0;0;0;0
1662;0;0;0;0;0
1663;150;339;308;0;797
1664;96;704;352;0;1152
1665;0;0;0;0;0
1666;0;162;132;0;294
1667;233;548;230;0;1011
1668;141;480;88;0;709
1669;159;457;258;0;874
1672;192;544;440;0;1176
1674;139;396;308;0;843
1675;324;464;220;0;1008
1676;114;660;352;0;1126
1677;204;389;176;0;769
1678;65;363;132;0;560
1680;89;214;88;0;391
1681;119;426;490;0;1035
1682;254;386;308;0;948
1683;96;378;220;0;694
1684;97;540;264;0;901
1685;168;729;348;0;1245
1686;276;364;206;0;846
1688;70;368;220;0;658
1689;165;590;305;0;1060
1691;49;170;88;0;307
1692;163;565;264;0;992
1693;48;118;132;0;298
1695;113;240;176;0;529
1696;58;280;176;0;514
1697;60;176;206;0;442
1698;261;392;176;0;829
1699;174;483;265;0;922
1700;67;206;132;0;405
1701;98;330;88;0;516
1702;62;264;172;0;498
1703;0;220;132;0;352
1704;231;176;176;0;583
1705;111;368;132;0;611
1707;107;426;264;0;797
1708;79;440;176;0;695
1709;54;442;0;0;496
1710;15;142;88;0;245
1712;93;248;132;0;473
1713;0;0;0;0;0
1714;95;164;88;0;347
1715;0;0;0;0;0
1716;142;422;220;0;784
1717;98;88;88;0;274
1718;39;148;88;0;275
1719;0;0;0;0;0
1720;59;290;132;0;481
1721;56;170;132;0;358
1722;102;214;88;0;404
1724;183;428;132;0;743
1728;61;164;88;0;313
1729;0;0;0;0;0
1730;0;0;0;0;0
1732;88;162;88;0;338
1734;309;132;44;0;485
1735;284;986;664;0;1934
1738;160;1054;0;0;1214
1739;154;456;250;0;860
1741;30;401;135;0;566
1742;138;74;180;0;392
1743;308;240;528;0;1076
1744;0;0;0;0;0
1745;0;0;0;0;0
1746;0;318;68;0;386
1747;56;210;180;0;446
1748;168;725;270;0;1163
1749;0;360;132;0;492
1750;272;440;237;0;949
1751;142;280;258;0;680
1752;263;361;255;0;879
1753;0;0;0;0;0
1755;316;945;575;0;1836
1756;186;540;405;0;1131
1757;390;1530;359;0;2279
1758;0;90;77;0;167
1759;44;159;45;0;248
1760;0;215;69;0;284
1761;189;25;158;0;372
1762;0;0;0;0;0
1763;84;367;122;0;573
1765;65;140;90;0;295
1766;0;0;0;0;0
1767;0;0;0;0;0
1769;85;0;380;0;465
1772;134;75;224;0;433
1774;0;0;0;0;0
1775;0;0;0;0;0
1776;0;0;0;0;0
1777;32;121;0;0;153
1778;0;0;0;0;0
1780;0;0;0;0;0
1781;643;719;0;0;1362
1783;0;0;0;0;0
1786;0;0;0;0;0
1787;0;45;0;0;45
1788;304;933;1305;0;2542
1789;84;492;180;0;756
1790;0;0;0;0;0
1791;0;0;0;0;0
1792;119;257;135;0;511
1793;0;0;0;0;0
1794;0;0;0;0;0
1795;55;700;450;0;1205
1796;224;248;335;0;807
1800;0;0;0;0;0
1801;130;780;535;0;1445
1803;0;0;0;0;0
1806;0;0;0;0;0
1807;48;74;65;0;187
1809;0;0;0;0;0
1810;0;0;0;0;0
1812;0;0;0;0;0
1813;0;0;0;0;0
1815;0;0;0;0;0
1817;0;0;0;0;0
1819;156;90;20;0;266
1823;0;132;40;0;172
1826;0;0;0;0;0
1828;0;0;0;0;0
1829;0;0;0;0;0
1830;0;0;0;0;0
1837;0;0;0;0;0
1838;0;0;0;0;0
1839;346;673;1315;0;2334
1840;0;0;0;0;0
1842;114;150;232;0;496
1844;0;0;0;0;0
1846;0;0;0;0;0
1847;24;90;90;0;204
1848;0;0;0;0;0
1850;0;0;0;0;0
1851;160;778;88;0;1026
1853;170;596;132;0;898
1854;0;0;0;0;0
1855;302;906;440;0;1648
1856;115;176;176;0;467
1857;11;88;44;0;143
1858;261;291;801;0;1353
1859;203;236;344;0;783
1860;191;634;225;0;1050
1861;0;0;0;0;0
1862;0;0;0;0;0
1863;332;772;434;0;1538
1864;172;696;338;0;1206
1867;113;470;114;0;697
1868;108;482;88;0;678
1869;57;0;38;0;95
1870;52;142;30;0;224
1871;42;144;62;0;248
1872;0;0;0;0;0
1873;88;164;198;0;450
1874;225;44;88;0;357
1875;167;195;44;0;406
1876;0;0;38;0;38
1877;18;76;30;0;124
1878;33;84;44;0;161
1879;0;0;0;0;0
1880;84;132;222;0;438
1881;179;352;524;0;1055
1882;89;352;264;0;705
1884;109;440;309;0;858
1885;221;386;208;0;815
1886;211;862;264;0;1337
1887;317;806;89;0;1212
1888;128;324;132;0;584
1889;180;456;129;0;765
1890;129;269;118;0;516
1891;227;397;264;0;888
1892;89;170;220;0;479
1893;63;361;158;0;582
1894;2;250;222;0;474
1895;91;404;309;0;804
1896;0;0;0;0;0
1898;222;212;260;0;694
1899;98;360;88;0;546
1900;10;64;44;0;118
1901;0;0;44;0;44
1903;0;0;0;0;0
1904;0;0;0;0;0
1905;6;0;44;0;50
1906;12;36;88;0;136
1908;85;225;90;0;400
1909;155;769;595;0;1519
1910;0;0;0;0;0
1911;180;536;303;0;1019
1913;0;0;0;0;0
1914;432;162;270;0;864
1917;95;91;90;0;276
1918;370;645;468;0;1483
1919;0;485;278;0;763
1920;0;32;32;0;64
1921;0;0;0;0;0
1922;0;0;0;0;0
1923;46;129;357;0;532
1924;44;195;83;0;322
1925;0;0;0;0;0
1926;0;0;0;0;0
1927;40;218;45;0;303
1928;0;0;0;0;0
1930;98;135;65;0;298
1931;26;137;30;0;193
1932;64;165;45;0;274
1934;220;1103;427;0;1750
1935;0;0;0;0;0
1936;0;0;0;0;0
1937;300;120;263;0;683
1938;0;0;0;0;0
1941;115;327;315;0;757
1942;0;0;0;0;0
1948;0;0;0;0;0
1949;180;0;97;0;277
1954;0;0;0;0;0
1956;0;0;0;0;0
1958;208;441;225;0;874
1959;273;415;164;0;852
1960;0;0;0;0;0
1961;267;368;267;0;902
1962;0;0;0;0;0
1963;184;354;225;0;763
1965;180;298;203;0;681
1966;199;408;133;0;740
1967;570;761;896;0;2227
1968;156;75;139;0;370
1969;276;466;219;0;961
1970;90;425;114;0;629
1971;346;305;75;0;726
1972;68;70;224;0;362
1973;0;0;0;0;0
1975;146;415;90;0;651
1976;12;25;44;0;81
1977;572;1939;255;0;2766
1980;45;396;45;0;486
1982;0;0;0;0;0
1983;0;0;0;0;0
1985;14;178;25;0;217
1987;92;105;135;0;332
1988;0;0;0;0;0
1989;0;0;0;0;0
1990;0;0;0;0;0
1992;0;0;0;0;0
1993;0;0;0;0;0
1996;177;484;220;0;881
1997;128;600;387;0;1115
1998;191;468;220;0;879
1999;238;582;350;0;1170
2000;0;0;0;0;0
2002;0;0;0;0;0
2003;33;126;88;0;247
2004;0;0;0;0;0
2005;131;128;88;0;347
2006;0;0;0;0;0
2007;45;265;135;0;445
2008;40;178;90;0;308
2009;121;70;90;0;281
2011;38;74;88;0;200
2012;94;308;220;0;622
2013;140;676;462;0;1278
2014;292;170;220;0;682
2017;128;88;88;0;304
2018;306;780;396;0;1482
2019;548;260;132;0;940
2020;283;88;88;0;459
2021;740;910;162;0;1812
2022;342;164;216;0;722
2023;159;190;176;0;525
2024;279;0;165;0;444
2025;0;220;44;0;264
2026;579;278;290;0;1147
2027;297;158;44;0;499
2028;14;176;44;0;234
2031;0;0;0;0;0
2033;0;0;0;0;0
2034;0;0;0;0;0
2035;249;85;176;0;510
2036;100;44;84;0;228
2037;203;76;44;0;323
2038;0;38;44;0;82
2039;0;0;0;0;0
2040;24;585;210;0;819
2041;76;828;308;0;1212
2042;143;395;775;0;1313
2043;166;270;90;0;526
2044;45;467;450;0;962
2045;57;323;259;0;639
2047;275;368;355;0;998
2048;60;302;120;0;482
2049;13;605;281;0;899
2050;148;305;270;0;723
2051;0;0;0;0;0
2052;89;175;135;0;399
2053;19;261;45;0;325
2054;0;44;30;0;74
2055;0;75;338;0;413
2057;4;69;0;0;73
2058;0;0;0;0;0
2061;0;0;0;0;0
2064;134;566;308;0;1008
2065;252;1304;352;0;1908
2066;274;874;396;0;1544
2067;0;0;0;0;0
2068;183;202;88;0;473
2069;159;80;44;0;283
2071;58;88;44;0;190
2072;0;0;0;0;0
2073;0;0;0;0;0
2074;286;365;220;0;871
2075;243;503;346;0;1092
2076;0;0;0;0;0
2078;177;331;308;0;816
2079;117;504;176;0;797
2081;93;486;176;0;755
2083;228;281;190;0;699
2084;210;573;312;0;1095
2085;110;169;132;0;411
2086;0;0;0;0;0
2087;62;0;44;0;106
2089;0;32;55;0;87
2090;182;216;180;0;578
2091;350;1076;436;0;1862
2092;204;160;176;0;540
2093;0;0;44;0;44
2095;0;40;40;0;80
2096;68;40;128;0;236
2097;0;0;0;0;0
2098;0;0;0;0;0
2099;123;181;281;0;585
2100;0;0;0;0;0
2101;504;368;416;0;1288
2102;277;229;222;0;728
2103;45;972;270;0;1287
2104;150;748;397;0;1295
2105;456;264;405;0;1125
2106;0;0;0;0;0
2107;0;0;0;0;0
2108;0;0;0;0;0
2109;92;448;140;0;680
2110;403;1137;708;0;2248
2111;430;480;352;0;1262
2112;295;1132;308;0;1735
2114;99;1489;347;0;1935
2115;160;555;133;0;848
2116;327;790;220;0;1337
2117;0;0;0;0;0
2118;280;1013;220;0;1513
2119;177;460;177;0;814
2120;349;926;265;0;1540
2121;276;898;220;0;1394
2122;151;580;88;0;819
2123;152;1054;308;0;1514
2124;305;870;221;0;1396
2125;183;409;132;0;724
2126;103;750;88;0;941
2129;246;1282;352;0;1880
2131;90;583;44;0;717
2132;177;705;198;0;1080
2133;149;659;132;0;940
2134;113;563;176;0;852
2135;77;618;132;0;827
2136;58;358;126;0;542
2137;0;0;0;0;0
2138;87;255;178;0;520
2139;43;448;132;0;623
2140;225;643;176;0;1044
2141;0;0;0;0;0
2143;129;588;132;0;849
2145;30;79;44;0;153
2146;101;186;44;0;331
2147;51;227;88;0;366
2148;0;0;0;0;0
2150;69;393;240;0;702
2151;40;85;198;0;323
2153;0;25;90;0;115
2155;71;912;195;0;1178
2156;0;0;0;0;0
2159;281;656;360;0;1297
2160;377;446;90;0;913
2162;90;402;90;0;582
2163;243;90;90;0;423
2164;60;595;270;0;925
2165;106;696;241;0;1043
2166;45;580;260;0;885
2167;145;45;180;0;370
2168;0;0;0;0;0
2169;0;0;0;0;0
2170;0;143;90;0;233
2171;0;275;45;0;320
2172;0;0;0;0;0
2173;44;158;90;0;292
2174;62;301;66;0;429
2177;0;0;0;0;0
2178;198;577;180;0;955
2179;110;475;265;0;850
2180;0;0;0;0;0
2182;64;454;90;0;608
2183;132;114;381;0;627
2184;0;0;20;0;20
2185;0;0;0;0;0
2186;0;0;0;0;0
2191;0;0;0;0;0
2193;0;0;0;0;0
2194;689;218;630;0;1537
2196;0;0;0;0;0
2197;0;0;0;0;0
2198;0;0;0;0;0
2200;0;204;180;0;384
2201;0;0;0;0;0
2202;0;0;0;0;0
2203;0;0;0;0;0
2204;0;0;0;0;0
2205;244;176;220;0;640
2206;188;490;88;0;766
2207;256;494;132;0;882
2209;329;288;220;0;837
2210;221;570;88;0;879
2212;161;176;176;0;513
2214;0;0;0;0;0
2215;0;0;0;0;0
2217;234;513;153;0;900
2218;165;516;405;0;1086
2219;113;215;290;0;618
2220;33;203;45;0;281
2222;132;466;220;0;818
2223;208;740;220;0;1168
2224;153;824;44;0;1021
2226;96;454;44;0;594
2227;75;366;132;0;573
2228;127;472;88;0;687
2229;0;0;0;0;0
2231;124;436;88;0;648
2232;39;262;74;0;375
2233;20;105;143;0;268
2234;286;1277;187;0;1750
2235;48;192;162;0;402
2236;38;144;189;0;371
2237;77;44;279;0;400
2238;46;38;110;0;194
2240;34;233;84;0;351
2243;39;153;114;0;306
2244;0;65;79;0;144
2246;125;332;44;0;501
2247;159;791;280;0;1230
2248;346;104;148;0;598
2249;185;526;354;0;1065
2250;92;356;209;0;657
2251;156;271;220;0;647
2253;0;0;0;0;0
2255;28;55;44;0;127
2257;0;38;44;0;82
2258;24;166;52;0;242
2259;120;651;225;0;996
2260;430;915;661;0;2006
2262;178;674;220;0;1072
2263;198;504;132;0;834
2264;96;186;126;0;408
2265;169;420;88;0;677
2266;135;277;88;0;500
2267;0;559;132;0;691
2268;40;120;88;0;248
2269;26;0;44;0;70
2270;0;0;0;0;0
2271;26;0;44;0;70
2272;0;0;0;0;0
2274;18;8;44;0;70
2275;152;440;132;0;724
2276;0;0;0;0;0
2277;0;0;0;0;0
2278;457;1042;750;0;2249
2279;169;489;108;0;766
2280;389;396;264;0;1049
2281;0;0;0;0;0
2282;52;228;44;0;324
2283;161;860;308;0;1329
2284;99;848;220;0;1167
2285;216;441;176;0;833
2286;402;1510;132;0;2044
2288;155;249;44;0;448
2289;120;874;264;0;1258
2291;242;684;176;0;1102
2292;214;337;88;0;639
2293;59;104;80;0;243
2294;473;249;197;0;919
2295;0;0;0;0;0
2296;54;142;44;0;240
2297;43;122;128;0;293
2298;0;0;0;0;0
2299;22;156;132;0;310
2300;189;365;220;0;774
2301;199;349;143;0;691
2302;96;272;82;0;450
2304;45;124;30;0;199
2307;23;60;44;0;127
2308;8;858;417;0;1283
2309;150;242;270;0;662
2310;200;498;132;0;830
2311;137;406;118;0;661
2312;30;400;88;0;518
2313;53;182;154;0;389
2314;18;206;122;0;346
2317;0;0;0;0;0
2318;0;0;0;0;0
2319;493;948;484;0;1925
2320;156;429;88;0;673
2321;129;386;132;0;647
2322;38;0;40;0;78
2324;288;370;88;0;746
2325;222;305;170;0;697
2326;144;446;983;0;1573
2327;28;108;82;0;218
2328;88;282;264;0;634
2329;117;854;683;0;1654
2330;144;998;426;0;1568
2331;28;82;44;0;154
2332;0;0;0;0;0
2333;46;150;88;0;284
2334;129;148;82;0;359
2335;45;30;44;0;119
2336;67;168;132;0;367
2338;20;187;44;0;251
2339;98;96;570;0;764
2341;0;0;0;0;0
2342;0;0;0;0;0
2343;6;9;104;0;119
2345;0;0;0;0;0
2346;0;0;0;0;0
2347;13;91;88;0;192
2348;45;141;132;0;318
2349;88;0;44;0;132
2350;0;38;24;0;62
2351;0;0;0;0;0
2352;0;0;30;0;30
2353;0;0;22;0;22
2355;243;0;603;0;846
2356;72;401;347;0;820
2358;0;45;60;0;105
2359;103;292;88;0;483
2360;92;350;176;0;618
2361;213;907;132;0;1252
2362;82;246;88;0;416
2363;168;148;238;0;554
2364;84;302;108;0;494
2365;126;619;88;0;833
2366;51;123;44;0;218
2367;43;272;44;0;359
2369;0;0;0;0;0
2370;0;0;0;0;0
2372;0;40;76;0;116
2373;40;168;44;0;252
2374;32;66;114;0;212
2375;113;480;176;0;769
2376;0;0;0;0;0
2377;0;0;0;0;0
2378;142;278;352;0;772
2379;310;670;392;0;1372
2380;202;329;132;0;663
2381;230;206;132;0;568
2383;0;0;0;0;0
2384;123;279;176;0;578
2386;95;531;200;0;826
2387;197;295;176;0;668
2388;26;369;132;0;527
2389;72;258;176;0;506
2390;36;290;88;0;414
2391;99;78;44;0;221
2392;12;127;44;0;183
2393;8;118;44;0;170
2394;7;107;44;0;158
2395;48;233;88;0;369
2396;14;35;44;0;93
2397;101;505;220;0;826
2398;49;247;88;0;384
2400;88;363;135;0;586
2401;134;422;360;0;916
2406;51;147;44;0;242
2407;66;208;107;0;381
2409;67;328;88;0;483
2410;10;103;44;0;157
2411;154;414;176;0;744
2412;189;862;308;0;1359
2413;57;114;88;0;259
2414;201;344;220;0;765
2415;219;485;88;0;792
2416;62;296;88;0;446
2417;30;44;44;0;118
2419;195;84;44;0;323
2420;145;221;88;0;454
2422;686;1175;472;0;2333
2423;362;1370;308;0;2040
2424;137;464;220;0;821
2425;197;490;88;0;775
2426;245;887;176;0;1308
2427;128;621;0;0;749
2428;114;507;88;0;709
2429;148;489;88;0;725
2430;0;0;0;0;0
2431;0;0;0;0;0
2432;156;561;132;0;849
2433;0;0;0;0;0
2436;15;0;79;0;94
2437;0;38;30;0;68
2438;40;88;36;0;164
2439;0;44;44;0;88
2440;14;4;44;0;62
2441;0;0;0;0;0
2442;321;340;477;0;1138
2443;129;528;392;0;1049
2444;77;660;353;0;1090
2445;0;0;0;0;0
2446;0;0;0;0;0
2447;183;752;485;0;1420
2448;113;1541;1101;0;2755
2450;0;0;0;0;0
2451;0;0;0;0;0
2453;278;270;492;0;1040
2454;196;1084;585;0;1865
2455;275;1361;900;0;2536
2456;80;658;485;0;1223
2457;153;786;264;0;1203
2458;202;484;220;0;906
2459;114;352;244;0;710
2460;84;484;352;0;920
2461;339;780;396;0;1515
2462;178;402;132;0;712
2463;182;616;220;0;1018
2464;34;220;44;0;298
2465;24;308;309;0;641
2467;63;176;132;0;371
2468;0;0;0;0;0
2469;21;176;176;0;373
2470;25;250;88;0;363
2471;18;132;88;0;238
2472;59;176;88;0;323
2473;0;0;0;0;0
2475;1;76;44;0;121
2476;15;151;132;0;298
2477;0;0;0;0;0
2480;0;0;0;0;0
2481;0;0;0;0;0
2482;0;0;0;0;0
2484;0;0;0;0;0
2485;213;810;1035;0;2058
2486;452;748;484;0;1684
2487;335;981;253;0;1569
2488;289;592;396;0;1277
2489;227;176;689;0;1092
2490;204;120;88;0;412
2491;128;88;165;0;381
2492;112;192;88;0;392
2493;128;402;118;0;648
2494;178;324;178;0;680
2495;252;396;132;0;780
2496;48;0;88;0;136
2498;137;229;132;0;498
2499;0;0;0;0;0
2500;78;44;190;0;312
2501;47;79;44;0;170
2503;0;0;0;0;0
2505;98;146;88;0;332
2506;47;44;82;0;173
2507;0;0;44;0;44
2508;294;88;132;0;514
2509;148;84;88;0;320
2510;0;0;0;0;0
2511;0;0;0;0;0
2513;182;44;88;0;314
2514;45;0;288;0;333
2517;170;355;225;0;750
2518;209;407;132;0;748
2519;149;0;128;0;277
2520;66;170;88;0;324
2521;56;125;74;0;255
2522;9;46;44;0;99
2523;54;132;126;0;312
2524;76;56;88;0;220
2525;257;327;308;0;892
2526;23;152;94;0;269
2527;64;464;88;0;616
2528;173;596;132;0;901
2529;32;38;44;0;114
2530;234;554;264;0;1052
2531;184;492;270;0;946
2532;459;1434;352;0;2245
2534;0;0;44;0;44
2535;9;44;44;0;97
2536;6;36;44;0;86
2537;25;230;88;0;343
2538;122;88;44;0;254
2539;84;468;132;0;684
2540;9;44;44;0;97
2541;0;30;44;0;74
2542;76;408;136;0;620
2543;12;36;22;0;70
2544;0;99;44;0;143
2545;7;30;22;0;59
2546;0;0;44;0;44
2548;0;0;44;0;44
2549;22;0;0;0;22
2551;366;1052;429;0;1847
2552;347;750;440;0;1537
2553;575;1540;338;0;2453
2554;170;531;106;0;807
2555;74;671;264;0;1009
2556;162;258;176;0;596
2557;20;88;88;0;196
2558;9;110;44;0;163
2559;304;549;88;0;941
2560;34;182;121;0;337
2561;24;110;88;0;222
2562;182;354;220;0;756
2563;32;162;44;0;238
2565;119;271;132;0;522
2566;48;342;176;0;566
2567;0;0;0;0;0
2568;14;38;44;0;96
2569;0;0;0;0;0
2570;30;86;121;0;237
2572;20;34;37;0;91
2573;0;0;0;0;0
2574;0;0;0;0;0
2575;14;44;44;0;102
2576;34;84;88;0;206
2577;70;215;44;0;329
2579;312;1450;834;0;2596
2580;246;412;420;0;1078
2582;0;0;0;0;0
2583;257;304;308;0;869
2584;260;387;118;0;765
2586;0;0;0;0;0
2587;0;0;0;0;0
2588;0;0;0;0;0
2589;0;0;0;0;0
2590;15;2;10;0;27
2591;19;30;22;0;71
2592;0;30;0;0;30
2593;0;0;0;0;0
2594;20;38;10;0;68
2596;0;0;0;0;0
2597;0;0;0;0;0
2598;24;44;0;0;68
2599;28;132;88;0;248
2601;26;0;44;0;70
2602;0;0;0;0;0
2603;0;44;0;0;44
2604;0;44;0;0;44
2607;0;44;0;0;44
2609;0;0;0;0;0
2610;0;0;0;0;0
2611;284;478;264;0;1026
2612;493;586;286;0;1365
2613;80;151;88;0;319
2615;180;536;106;0;822
2617;0;0;22;0;22
2618;0;0;0;0;0
2620;0;0;0;0;0
2621;40;44;44;0;128
2622;122;0;44;0;166
2623;0;0;0;0;0
2624;46;0;44;0;90
2625;256;769;484;0;1509
2626;217;853;44;0;1114
2627;58;246;88;0;392
2629;44;75;88;0;207
2630;0;0;0;0;0
2632;0;0;0;0;0
2633;0;31;20;0;51
2634;0;0;30;0;30
2635;173;783;308;0;1264
2636;61;418;176;0;655
2637;30;0;44;0;74
2639;0;0;20;0;20
2640;0;0;0;0;0
2641;0;0;0;0;0
2642;0;44;15;0;59
2643;4;44;10;0;58
2644;0;0;0;0;0
2646;7;0;12;0;19
2647;0;0;22;0;22
2648;0;0;0;0;0
2649;0;0;0;0;0
2650;61;172;88;0;321
2651;0;0;0;0;0
2652;0;0;30;0;30
2654;167;534;176;0;877
2655;0;0;0;0;0
2656;223;848;270;0;1341
2657;440;612;352;0;1404
2658;206;132;132;0;470
2660;194;132;176;0;502
2661;0;0;0;0;0
2663;0;0;0;0;0
2664;196;264;88;0;548
2665;0;0;0;0;0
2666;0;82;44;0;126
2667;0;0;0;0;0
2668;0;0;0;0;0
2669;0;0;0;0;0
2670;0;0;0;0;0
2671;0;0;0;0;0
2672;0;0;0;0;0
2673;0;44;0;0;44
2674;0;0;0;0;0
2675;0;0;0;0;0
2678;20;0;20;0;40
2679;0;0;0;0;0
2680;0;0;0;0;0
2681;108;504;220;0;832
2682;80;279;88;0;447
2684;0;0;0;0;0
2685;22;0;22;0;44
2686;26;176;44;0;246
2687;0;0;0;0;0
2688;0;0;0;0;0
2689;0;0;0;0;0
2690;0;0;0;0;0
2691;0;0;0;0;0
2692;0;0;22;0;22
2694;114;782;176;0;1072
2697;0;0;0;0;0
2698;8;30;22;0;60
2699;0;0;0;0;0
2700;12;124;74;0;210
2701;91;664;84;0;839
2702;2;41;40;0;83
2703;24;124;88;0;236
2704;5;104;63;0;172
2705;4;30;8;0;42
2706;16;0;40;0;56
2707;80;351;124;0;555
2708;88;402;162;0;652
2710;0;0;0;0;0
2711;16;44;20;0;80
2713;0;0;0;0;0
2714;35;176;44;0;255
2715;104;238;214;0;556
2716;11;111;44;0;166
2717;22;99;74;0;195
2718;0;0;0;0;0
2719;19;0;0;0;19
2720;0;0;0;0;0
2721;8;0;44;0;52
2722;5;0;30;0;35
2723;5;0;0;0;5
2724;4;0;0;0;4
2725;9;0;0;0;9
2727;0;0;0;0;0
2728;8;0;60;0;68
2729;0;0;0;0;0
2730;114;543;132;0;789
2731;0;0;0;0;0
2732;49;528;485;0;1062
2733;74;440;221;0;735
2734;222;810;287;0;1319
2735;92;299;266;0;657
2736;653;368;582;0;1603
2737;235;367;221;0;823
2738;306;598;264;0;1168
2739;0;0;0;0;0
2740;176;403;286;0;865
2741;164;359;221;0;744
2742;193;785;305;0;1283
2744;521;802;441;0;1764
2745;440;773;132;0;1345
2747;87;276;133;0;496
2748;144;176;536;0;856
2749;144;88;384;0;616
2750;130;176;88;0;394
2751;28;118;132;0;278
2753;555;150;176;0;881
2754;28;260;132;0;420
2755;181;475;353;0;1009
2756;45;44;358;0;447
2758;83;193;136;0;412
2759;24;0;44;0;68
2761;128;44;346;0;518
2762;42;107;44;0;193
2763;80;70;88;0;238
2764;107;36;88;0;231
2765;24;0;44;0;68
2766;18;56;83;0;157
2767;101;157;66;0;324
2768;4;0;66;0;70
2769;0;0;0;0;0
2770;0;0;0;0;0
2771;18;104;44;0;166
2772;0;0;0;0;0
2773;0;0;0;0;0
2775;0;0;22;0;22
2776;44;144;88;0;276
2777;0;0;0;0;0
2778;0;0;0;0;0
2779;0;0;0;0;0
2780;48;110;44;0;202
2781;0;0;0;0;0
2782;55;694;903;0;1652
2784;0;0;0;0;0
2785;0;759;453;0;1212
2786;0;0;0;0;0
2787;95;920;255;0;1270
2789;207;88;650;0;945
2790;0;0;0;0;0
2793;437;220;560;0;1217
2794;308;856;220;0;1384
2795;302;960;220;0;1482
2796;144;132;694;0;970
2797;0;0;0;0;0
2799;97;208;45;0;350
2800;76;100;132;0;308
2801;105;288;88;0;481
2802;132;675;44;0;851
2803;148;618;132;0;898
2804;56;296;88;0;440
2805;70;242;44;0;356
2806;70;249;44;0;363
2808;0;0;0;0;0
2809;28;44;84;0;156
2812;0;0;0;0;0
2813;0;0;0;0;0
2814;117;120;164;0;401
2815;0;0;0;0;0
2816;32;83;44;0;159
2817;132;774;220;0;1126
2818;0;0;0;0;0
2819;0;44;15;0;59
2820;61;120;44;0;225
2821;8;0;40;0;48
2822;102;343;119;0;564
2823;82;424;258;0;764
2825;120;143;236;0;499
2826;86;299;166;0;551
2827;206;53;114;0;373
2828;0;0;0;0;0
2829;25;98;88;0;211
2830;65;162;200;0;427
2831;0;0;82;0;82
2832;0;0;82;0;82
2833;100;224;315;0;639
2834;0;0;0;0;0
2835;398;300;308;0;1006
2836;262;465;132;0;859
2837;0;0;0;0;0
2839;273;206;220;0;699
2840;222;420;176;0;818
2842;47;214;88;0;349
2843;87;176;88;0;351
2844;125;220;88;0;433
2845;163;837;132;0;1132
2846;141;88;42;0;271
2847;97;510;220;0;827
2848;26;132;74;0;232
2849;0;0;0;0;0
2850;44;0;25;0;69
2851;0;0;30;0;30
2852;0;0;0;0;0
2854;151;44;44;0;239
2856;0;0;0;0;0
2857;0;0;0;0;0
2858;0;0;30;0;30
2859;156;220;484;0;860
2860;105;69;56;0;230
2861;44;30;44;0;118
2862;594;50;570;0;1214
2863;215;789;210;0;1214
2864;0;225;90;0;315
2865;0;501;717;0;1218
2866;145;682;132;0;959
2867;210;548;128;0;886
2868;192;296;88;0;576
2870;69;252;172;0;493
2871;273;508;88;0;869
2873;55;292;88;0;435
2874;0;0;0;0;0
2875;139;74;44;0;257
2876;38;106;74;0;218
2877;0;35;22;0;57
2878;0;0;0;0;0
2879;0;0;44;0;44
2880;0;0;0;0;0
2882;153;378;176;0;707
2883;121;408;120;0;649
2884;145;198;88;0;431
2885;49;0;44;0;93
2887;0;0;0;0;0
2888;24;0;110;0;134
2889;0;0;0;0;0
2890;0;35;88;0;123
2891;0;0;0;0;0
2892;15;32;44;0;91
2893;5;0;44;0;49
2894;110;88;291;0;489
2895;108;0;87;0;195
2896;204;1091;396;0;1691
2898;0;0;0;0;0
2900;0;0;0;0;0
2901;76;38;44;0;158
2902;0;0;0;0;0
2903;42;229;132;0;403
2904;0;0;0;0;0
2906;0;0;0;0;0
2907;0;45;45;0;90
2908;23;153;88;0;264
2909;111;231;222;0;564
2910;89;503;176;0;768
2911;22;233;110;0;365
2912;0;0;0;0;0
2913;0;0;0;0;0
2914;12;45;44;0;101
2915;0;0;0;0;0
2916;0;0;22;0;22
2917;181;439;210;0;830
2918;130;38;172;0;340
2920;201;281;135;0;617
2921;19;38;25;0;82
2923;0;0;0;0;0
2925;0;0;0;0;0
2926;0;0;0;0;0
2927;109;200;90;0;399
2928;0;0;25;0;25
2929;0;0;0;0;0
2930;332;940;484;0;1756
2931;176;616;264;0;1056
2932;155;808;198;0;1161
2933;158;176;396;0;730
2934;474;1038;572;0;2084
2935;294;1320;572;0;2186
2937;470;704;528;0;1702
2938;349;1575;660;0;2584
2939;142;690;176;0;1008
2940;198;426;396;0;1020
2941;211;354;220;0;785
2942;160;2082;308;0;2550
2943;85;220;176;0;481
2944;373;930;484;0;1787
2945;258;688;264;0;1210
2946;228;620;308;0;1156
2947;67;352;132;0;551
2948;277;1434;484;0;2195
2949;544;736;352;0;1632
2950;186;431;220;0;837
2951;115;420;176;0;711
2952;295;330;176;0;801
2954;0;0;0;0;0
2955;102;258;162;0;522
2956;313;798;220;0;1331
2957;314;558;220;0;1092
2958;390;632;220;0;1242
2959;293;472;176;0;941
2960;0;0;0;0;0
2961;88;44;0;0;132
2964;275;324;798;0;1397
2965;203;730;308;0;1241
2966;165;126;170;0;461
2968;198;260;220;0;678
2972;326;704;264;0;1294
2973;340;1448;880;0;2668
2974;73;332;176;0;581
2975;129;312;176;0;617
2976;0;0;0;0;0
2977;121;461;176;0;758
2978;190;288;368;0;846
2979;123;718;176;0;1017
2980;124;88;132;0;344
2981;73;244;176;0;493
2983;76;92;132;0;300
2985;0;0;0;0;0
2986;118;118;264;0;500
2989;60;151;88;0;299
2990;430;1112;444;0;1986
2991;165;529;225;0;919
2992;128;1003;315;0;1446
2993;219;264;180;0;663
2994;134;675;157;0;966
2995;427;978;351;0;1756
2996;0;0;0;0;0
2997;308;940;291;0;1539
2999;198;265;90;0;553
3002;123;267;336;0;726
3003;114;100;60;0;274
3005;70;383;517;0;970
3006;225;2038;855;0;3118
3007;0;0;0;0;0
3008;101;85;81;0;267
3009;0;0;0;0;0
3010;69;120;0;0;189
3011;0;0;0;0;0
3012;0;0;0;0;0
3013;75;630;90;0;795
3014;1264;670;720;0;2654
3015;225;180;629;0;1034
3016;215;376;220;0;811
3017;425;854;564;0;1843
3019;170;325;235;0;730
3020;68;350;212;0;630
3022;58;114;88;0;260
3023;64;106;30;0;200
3024;16;90;83;0;189
3025;33;261;128;0;422
3026;28;0;102;0;130
3027;0;0;0;0;0
3028;12;98;82;0;192
3029;45;64;15;0;124
3030;0;44;0;0;44
3032;136;225;45;0;406
3033;280;882;811;0;1973
3034;74;286;44;0;404
3036;24;0;74;0;98
3037;82;348;88;0;518
3038;17;120;44;0;181
3039;142;342;264;0;748
3040;0;0;0;0;0
3042;74;265;44;0;383
3043;0;0;0;0;0
3044;0;0;22;0;22
3045;0;44;88;0;132
3046;0;0;0;0;0
3047;44;44;68;0;156
3048;0;4;24;0;28
3050;0;0;0;0;0
3051;0;32;22;0;54
3053;0;0;0;0;0
3055;394;1637;158;0;2189
3056;154;1668;164;0;1986
3057;135;293;170;0;598
3058;90;38;330;0;458
3059;127;616;169;0;912
3060;208;1279;335;0;1822
3061;32;158;52;0;242
3062;48;52;142;0;242
3063;126;268;45;0;439
3065;30;281;82;0;393
3067;22;0;30;0;52
3068;107;95;64;0;266
3069;58;274;96;0;428
3070;84;414;112;0;610
3073;47;0;44;0;91
3076;23;0;30;0;53
3077;0;25;0;0;25
3078;0;0;0;0;0
3079;0;22;22;0;44
3080;0;0;0;0;0
3081;75;108;104;0;287
3082;0;0;22;0;22
3084;0;30;22;0;52
3085;67;244;176;0;487
3086;72;108;104;0;284
3088;16;0;0;0;16
3090;94;330;88;0;512
3091;0;0;0;0;0
3092;0;0;0;0;0
3093;0;30;22;0;52
3094;0;0;0;0;0
3095;0;0;0;0;0
3096;119;82;171;0;372
3098;0;0;0;0;0
3099;0;0;0;0;0
3100;0;0;0;0;0
3103;0;0;0;0;0
3104;0;0;38;0;38
3105;0;0;0;0;0
3106;39;96;44;0;179
3107;42;190;52;0;284
3108;40;529;226;0;795
3110;234;1034;242;0;1510
3111;231;1008;352;0;1591
3112;58;220;88;0;366
3113;188;452;88;0;728
3114;98;576;132;0;806
3115;52;132;162;0;346
3117;84;88;352;0;524
3118;53;166;88;0;307
3119;13;0;0;0;13
3121;9;36;44;0;89
3122;57;127;88;0;272
3123;3;0;15;0;18
3124;9;74;30;0;113
3125;8;0;30;0;38
3126;164;465;250;0;879
3127;241;423;1080;0;1744
3128;456;1660;660;0;2776
3129;0;0;44;0;44
3130;45;308;88;0;441
3131;0;0;0;0;0
3132;0;0;0;0;0
3134;25;244;88;0;357
3136;0;0;0;0;0
3137;0;0;0;0;0
3138;194;1322;372;0;1888
3139;61;88;44;0;193
3140;45;176;44;0;265
3141;0;44;0;0;44
3143;172;176;0;0;348
3146;0;0;0;0;0
3154;0;0;0;0;0
3156;0;0;0;0;0
3157;0;0;0;0;0
3158;0;0;44;0;44
3159;0;0;0;0;0
3161;0;44;0;0;44
3162;0;0;0;0;0
3163;45;609;403;0;1057
3165;384;956;484;0;1824
3166;313;1505;440;0;2258
3167;0;0;0;0;0
3168;278;506;264;0;1048
3169;290;1556;308;0;2154
3170;129;558;264;0;951
3171;0;0;0;0;0
3172;326;1038;572;0;1936
3173;974;602;308;0;1884
3174;156;264;220;0;640
3175;0;0;0;0;0
3176;0;88;44;0;132
3177;0;44;0;0;44
3179;0;0;0;0;0
3182;0;0;0;0;0
3183;0;0;0;0;0
3184;0;0;0;0;0
3185;285;342;176;0;803
3186;0;88;0;0;88
3187;0;0;44;0;44
3188;0;0;0;0;0
3189;0;0;0;0;0
3190;0;0;0;0;0
3191;24;68;88;0;180
3192;0;0;0;0;0
3193;0;0;0;0;0
3194;0;0;0;0;0
3196;0;44;0;0;44
3197;0;0;0;0;0
3198;0;0;0;0;0
3199;0;0;0;0;0
3201;30;650;201;0;881
3202;526;783;389;0;1698
3203;349;980;315;0;1644
3204;0;75;90;0;165
3205;135;396;308;0;839
3206;15;88;88;0;191
3207;315;1084;264;0;1663
3208;0;0;0;0;0
3209;73;258;126;0;457
3210;0;0;0;0;0
3211;0;0;0;0;0
3212;5;15;15;0;35
3213;0;0;0;0;0
3215;9;15;0;0;24
3216;0;0;0;0;0
3217;26;76;35;0;137
3218;0;0;0;0;0
3219;6;0;0;0;6
3220;0;0;0;0;0
3221;0;0;0;0;0
3222;0;0;0;0;0
3223;0;0;0;0;0
3224;0;0;0;0;0
3225;0;0;25;0;25
3226;0;0;0;0;0
3229;0;0;0;0;0
3230;0;23;0;0;23
3232;0;0;0;0;0
3233;0;0;0;0;0
3234;0;0;0;0;0
3235;0;0;0;0;0
3236;0;0;0;0;0
3238;20;117;0;0;137
3239;0;0;0;0;0
3240;0;0;0;0;0
3241;0;0;0;0;0
3242;0;0;30;0;30
3243;0;0;0;0;0
3244;160;662;176;0;998
3247;440;1683;880;0;3003
3248;633;1163;440;0;2236
3249;568;1907;352;0;2827
3250;161;909;308;0;1378
3251;329;1892;220;0;2441
3252;623;660;426;0;1709
3253;307;601;132;0;1040
3254;0;0;0;0;0
3255;176;1185;176;0;1537
3256;175;878;264;0;1317
3257;172;682;176;0;1030
3258;178;892;220;0;1290
3260;150;600;88;0;838
3261;366;582;220;0;1168
3263;139;299;88;0;526
3264;147;440;132;0;719
3265;14;44;44;0;102
3266;159;484;132;0;775
3267;340;974;220;0;1534
3268;257;649;264;0;1170
3269;165;560;220;0;945
3270;61;250;88;0;399
3271;0;30;0;0;30
3272;0;0;0;0;0
3273;100;150;88;0;338
3274;0;0;0;0;0
3275;0;0;0;0;0
3277;0;0;0;0;0
3278;0;0;0;0;0
3279;0;0;0;0;0
3280;0;0;0;0;0
3281;0;0;0;0;0
3282;0;0;0;0;0
3283;0;0;0;0;0
3284;0;0;0;0;0
3285;154;427;132;0;713
3286;0;0;0;0;0
3287;0;0;0;0;0
3288;0;0;0;0;0
3289;0;0;0;0;0
3290;326;702;584;0;1612
3291;83;530;90;0;703
3292;150;619;90;0;859
3294;69;450;180;0;699
3295;0;0;0;0;0
3296;249;2526;630;0;3405
3297;30;276;90;0;396
3298;105;1120;405;0;1630
3299;52;180;90;0;322
3300;215;407;550;0;1172
3301;0;0;0;0;0
3302;199;688;440;0;1327
3303;275;1120;180;0;1575
3304;232;1232;205;0;1669
3305;616;1398;616;0;2630
3306;0;0;0;0;0
3308;152;823;264;0;1239
3310;136;374;199;0;709
3311;86;433;180;0;699
3313;236;1218;308;0;1762
3314;75;172;88;0;335
3315;96;440;132;0;668
3316;54;220;88;0;362
3317;17;511;132;0;660
3318;61;88;88;0;237
3319;154;312;132;0;598
3320;54;120;132;0;306
3321;44;146;88;0;278
3322;16;0;44;0;60
3323;96;271;132;0;499
3325;99;263;66;0;428
3327;75;791;540;0;1406
3328;204;1076;308;0;1588
3329;92;484;88;0;664
3330;70;132;44;0;246
3331;0;0;0;0;0
3332;70;132;88;0;290
3333;43;264;132;0;439
3334;164;748;0;0;912
3335;228;970;352;0;1550
3336;0;88;88;0;176
3337;0;74;44;0;118
3338;0;132;44;0;176
3339;0;0;0;0;0
3340;0;44;44;0;88
3341;0;0;0;0;0
3342;0;0;0;0;0
3344;0;0;0;0;0
3345;44;170;44;0;258
3346;0;44;88;0;132
3347;117;277;120;0;514
3348;132;810;275;0;1217
3349;162;830;264;0;1256
3350;0;0;0;0;0
3351;0;0;0;0;0
3352;25;348;88;0;461
3353;48;273;44;0;365
3354;61;312;79;0;452
3355;6;309;132;0;447
3356;79;427;44;0;550
3358;27;169;83;0;279
3359;53;310;127;0;490
3361;88;498;176;0;762
3362;140;648;132;0;920
3363;0;0;0;0;0
3364;6;73;108;0;187
3365;112;117;44;0;273
3366;9;62;44;0;115
3367;0;0;10;0;10
3368;9;122;30;0;161
3369;0;0;20;0;20
3370;0;0;0;0;0
3371;77;175;44;0;296
3373;24;120;81;0;225
3375;0;0;10;0;10
3376;66;246;44;0;356
3377;0;0;20;0;20
3378;0;153;0;0;153
3379;0;0;0;0;0
3380;0;0;0;0;0
3381;29;226;44;0;299
3382;75;398;87;0;560
3383;3;13;44;0;60
3384;0;0;20;0;20
3385;0;167;45;0;212
3386;0;0;0;0;0
3387;262;840;489;0;1591
3389;160;336;132;0;628
3390;265;1060;220;0;1545
3393;286;462;133;0;881
3395;176;984;88;0;1248
3396;44;245;133;0;422
3397;0;0;0;0;0
3398;125;517;184;0;826
3399;0;0;0;0;0
3400;66;245;134;0;445
3401;24;324;133;0;481
3402;76;136;44;0;256
3403;0;88;0;0;88
3404;39;76;44;0;159
3405;0;0;56;0;56
3406;0;0;0;0;0
3408;0;130;44;0;174
3409;0;0;0;0;0
3411;0;0;0;0;0
3412;0;0;0;0;0
3413;0;0;22;0;22
3415;0;0;0;0;0
3417;0;0;10;0;10
3418;0;0;0;0;0
3419;0;0;44;0;44
3420;0;0;0;0;0
3421;0;0;10;0;10
3423;0;0;0;0;0
3425;0;0;0;0;0
3426;0;0;0;0;0
3427;0;0;0;0;0
3428;0;0;0;0;0
3429;0;0;0;0;0
3430;262;655;135;0;1052
3431;210;549;625;0;1384
3432;241;1362;660;0;2263
3433;129;449;225;0;803
3434;719;1292;737;0;2748
3435;258;1006;327;0;1591
3436;116;482;44;0;642
3437;39;152;44;0;235
3439;10;35;30;0;75
3440;36;209;77;0;322
3442;163;447;88;0;698
3443;168;665;162;0;995
3444;0;0;10;0;10
3445;41;236;66;0;343
3446;0;0;0;0;0
3447;0;0;2;0;2
3448;87;92;88;0;267
3449;0;32;44;0;76
3450;23;80;44;0;147
3451;0;0;0;0;0
3452;0;30;0;0;30
3453;16;111;44;0;171
3454;140;74;88;0;302
3456;0;0;0;0;0
3457;0;40;0;0;40
3458;53;27;44;0;124
3459;16;38;42;0;96
3460;313;900;540;0;1753
3461;131;335;257;0;723
3462;160;494;198;0;852
3463;25;2;67;0;94
3464;147;671;133;0;951
3465;39;74;88;0;201
3466;96;71;167;0;334
3467;34;195;44;0;273
3468;29;34;44;0;107
3470;111;333;44;0;488
3471;84;167;163;0;414
3473;0;0;0;0;0
3474;0;0;0;0;0
3475;93;265;66;0;424
3476;0;0;0;0;0
3477;0;0;0;0;0
3478;179;140;590;0;909
3479;495;1144;594;0;2233
3480;129;504;308;0;941
3481;191;505;220;0;916
3482;255;214;132;0;601
3483;192;1035;132;0;1359
3484;115;391;83;0;589
3487;0;0;0;0;0
3488;21;44;88;0;153
3489;0;250;44;0;294
3490;114;394;66;0;574
3491;159;132;88;0;379
3492;64;214;88;0;366
3494;46;88;118;0;252
3495;45;0;220;0;265
3496;0;0;0;0;0
3497;72;214;88;0;374
3499;0;0;0;0;0
3501;0;0;0;0;0
3502;0;0;35;0;35
3503;0;0;0;0;0
3504;0;0;0;0;0
3506;0;0;30;0;30
3507;0;0;0;0;0
3508;0;0;0;0;0
3509;0;0;0;0;0
3511;0;0;0;0;0
3512;0;0;0;0;0
3513;0;0;0;0;0
3514;0;0;0;0;0
3515;0;132;44;0;176
3516;0;0;0;0;0
3517;0;0;44;0;44
3518;0;0;0;0;0
3520;0;0;30;0;30
3521;0;0;0;0;0
3523;0;0;0;0;0
3524;0;0;0;0;0
3525;0;0;0;0;0
3526;0;0;0;0;0
3527;0;35;0;0;35
3528;0;0;0;0;0
3529;0;0;0;0;0
3530;368;803;264;0;1435
3531;0;689;360;0;1049
3532;15;403;113;0;531
3533;204;1264;561;0;2029
3534;0;0;0;0;0
3535;0;0;0;0;0
3537;164;528;88;0;780
3538;305;2794;506;0;3605
3539;200;1199;484;0;1883
3540;54;591;352;0;997
3541;196;1694;264;0;2154
3542;0;0;0;0;0
3544;98;1020;220;0;1338
3545;237;1312;352;0;1901
3546;0;485;88;0;573
3548;100;957;176;0;1233
3549;207;934;264;0;1405
3550;0;88;44;0;132
3551;79;588;118;0;785
3552;16;300;104;0;420
3554;8;406;132;0;546
3555;16;210;44;0;270
3559;0;0;30;0;30
3562;0;0;0;0;0
3564;0;0;22;0;22
3566;0;0;22;0;22
3568;0;0;22;0;22
3569;0;0;44;0;44
3571;0;0;0;0;0
3573;42;82;44;0;168
3574;0;0;0;0;0
3575;0;0;0;0;0
3576;0;0;0;0;0
3577;0;0;0;0;0
3578;0;0;0;0;0
3579;0;0;0;0;0
3580;0;0;22;0;22
3581;0;0;0;0;0
3582;0;0;22;0;22
3583;0;0;60;0;60
3585;0;0;0;0;0
3586;0;0;22;0;22
3587;0;0;0;0;0
3588;0;176;88;0;264
3594;0;0;22;0;22
3596;0;22;0;0;22
3599;43;0;22;0;65
3600;0;0;0;0;0
3601;0;0;0;0;0
3602;6;0;22;0;28
3604;8;0;22;0;30
3605;0;0;0;0;0
3607;0;0;0;0;0
3608;252;1306;380;0;1938
3609;401;2100;975;0;3476
3610;115;900;338;0;1353
3611;129;785;180;0;1094
3612;79;45;39;0;163
3613;0;0;0;0;0
3614;64;0;67;0;131
3615;17;55;45;0;117
3616;21;90;45;0;156
3618;97;572;311;0;980
3619;123;1269;199;0;1591
3621;162;1116;132;0;1410
3622;70;440;88;0;598
3623;6;352;0;0;358
3624;3;22;22;0;47
3625;3;44;22;0;69
3626;0;22;22;0;44
3627;0;0;0;0;0
3628;0;0;0;0;0
3629;0;0;22;0;22
3630;3;22;20;0;45
3631;3;44;22;0;69
3632;3;22;22;0;47
3633;0;44;22;0;66
3635;0;22;22;0;44
3636;0;44;22;0;66
3637;0;0;22;0;22
3638;214;1134;990;0;2338
3639;250;747;616;0;1613
3640;328;485;355;0;1168
3641;148;660;308;0;1116
3642;239;299;177;0;715
3643;116;554;132;0;802
3644;0;0;0;0;0
3645;0;264;132;0;396
3646;0;0;0;0;0
3647;0;0;0;0;0
3649;176;469;220;0;865
3650;36;176;88;0;300
3652;0;0;0;0;0
3653;88;352;308;0;748
3654;363;954;150;0;1467
3655;0;0;0;0;0
3656;260;875;264;0;1399
3657;378;660;308;0;1346
3658;78;162;132;0;372
3659;116;308;308;0;732
3660;22;316;176;0;514
3661;0;0;0;0;0
3662;281;571;396;0;1248
3663;495;648;484;0;1627
3664;215;260;352;0;827
3666;30;122;88;0;240
3667;59;242;176;0;477
3668;118;300;132;0;550
3669;167;464;346;0;977
3670;439;885;396;0;1720
3671;119;438;308;0;865
3672;146;131;88;0;365
3673;79;188;88;0;355
3674;61;228;132;0;421
3675;40;232;264;0;536
3676;0;0;0;0;0
3677;165;381;150;0;696
3678;29;132;88;0;249
3680;0;0;0;0;0
3681;82;122;88;0;292
3683;91;260;97;0;448
3684;0;0;0;0;0
3685;143;428;44;0;615
3686;15;179;47;0;241
3687;4;88;0;0;92
3688;0;0;0;0;0
3689;0;0;0;0;0
3690;0;0;0;0;0
3691;14;44;44;0;102
3692;0;0;0;0;0
3693;0;0;0;0;0
3694;11;34;45;0;90
3695;0;0;0;0;0
3697;0;0;44;0;44
3698;66;120;44;0;230
3699;0;0;0;0;0
3700;0;0;0;0;0
3702;0;0;0;0;0
3703;66;106;132;0;304
3704;34;0;88;0;122
3705;0;0;0;0;0
3706;0;0;0;0;0
3707;0;89;44;0;133
3708;0;0;0;0;0
3709;34;118;0;0;152
3710;0;48;0;0;48
3711;189;670;442;0;1301
3712;0;0;0;0;0
3713;249;2153;829;0;3231
3714;265;460;135;0;860
3716;40;247;45;0;332
3717;233;970;270;0;1473
3718;123;1582;497;0;2202
3719;268;501;225;0;994
3720;180;269;450;0;899
3722;0;0;0;0;0
3723;302;1927;315;0;2544
3724;451;552;405;0;1408
3725;25;142;45;0;212
3726;42;219;161;0;422
3727;24;45;45;0;114
3728;88;696;309;0;1093
3730;145;664;148;0;957
3731;65;108;133;0;306
3733;92;315;45;0;452
3734;240;362;133;0;735
3735;179;382;210;0;771
3736;0;0;0;0;0
3737;0;0;0;0;0
3738;0;0;0;0;0
3739;90;525;585;0;1200
3740;215;516;264;0;995
3741;23;164;0;0;187
3742;452;1256;660;0;2368
3743;316;1059;264;0;1639
3744;228;722;176;0;1126
3745;350;578;176;0;1104
3747;23;0;0;0;23
3748;130;599;132;0;861
3749;21;516;44;0;581
3750;0;0;0;0;0
3751;0;0;0;0;0
3752;0;0;0;0;0
3753;0;0;0;0;0
3754;15;60;44;0;119
3755;20;358;88;0;466
3756;0;0;0;0;0
3757;0;44;0;0;44
3758;46;122;88;0;256
3759;76;216;88;0;380
3760;80;276;88;0;444
3761;0;0;0;0;0
3762;115;293;88;0;496
3764;0;0;0;0;0
3765;0;0;0;0;0
3766;0;44;0;0;44
3767;0;0;0;0;0
3768;170;396;176;0;742
3769;0;0;0;0;0
3770;0;0;0;0;0
3771;0;0;0;0;0
3772;0;0;0;0;0
3773;0;0;0;0;0
3774;0;0;0;0;0
3775;0;0;0;0;0
3776;12;0;44;0;56
3778;0;0;0;0;0
3779;0;0;0;0;0
3781;14;53;44;0;111
3782;102;280;132;0;514
3783;15;0;30;0;45
3784;36;88;44;0;168
3785;0;25;25;0;50
3786;84;353;132;0;569
3787;0;0;0;0;0
3788;0;0;0;0;0
3789;0;0;0;0;0
3790;0;0;0;0;0
3791;0;44;0;0;44
3792;0;0;0;0;0
3793;0;0;0;0;0
3795;350;784;484;0;1618
3796;461;755;681;0;1897
3797;700;1056;499;0;2255
3798;116;170;236;0;522
3799;65;288;176;0;529
3800;76;358;74;0;508
3801;58;228;132;0;418
3802;338;1673;493;0;2504
3803;0;0;0;0;0
3804;39;178;44;0;261
3805;0;0;0;0;0
3806;0;0;0;0;0
3807;0;44;44;0;88
3808;0;44;0;0;44
3809;0;0;0;0;0
3810;0;0;0;0;0
3811;0;0;0;0;0
3812;0;0;0;0;0
3814;20;82;44;0;146
3815;81;162;88;0;331
3816;0;0;0;0;0
3817;0;0;0;0;0
3818;21;112;45;0;178
3819;0;0;0;0;0
3820;30;157;44;0;231
3821;0;0;0;0;0
3822;0;0;0;0;0
3823;282;1064;374;0;1720
3824;0;0;0;0;0
3825;0;0;0;0;0
3826;0;0;0;0;0
3828;0;62;0;0;62
3829;0;50;44;0;94
3831;124;362;44;0;530
3832;0;46;0;0;46
3833;42;90;44;0;176
3834;0;0;0;0;0
3835;380;919;220;0;1519
3836;148;242;84;0;474
3837;4;82;44;0;130
3838;0;118;44;0;162
3839;137;376;88;0;601
3840;75;368;44;0;487
3841;136;336;176;0;648
3842;116;352;88;0;556
3843;164;590;198;0;952
3845;0;0;0;0;0
3846;6;0;82;0;88
3847;0;0;0;0;0
3848;0;0;0;0;0
3849;72;84;88;0;244
3850;0;0;0;0;0
3851;0;0;0;0;0
3852;0;0;10;0;10
3853;8;30;44;0;82
3854;0;38;0;0;38
3855;9;405;88;0;502
3856;62;126;88;0;276
3857;20;0;50;0;70
3859;3;0;20;0;23
3860;0;0;0;0;0
3862;0;0;0;0;0
3863;0;0;0;0;0
3864;0;0;0;0;0
3865;160;590;225;0;975
3866;138;329;327;0;794
3867;73;0;23;0;96
3868;0;0;0;0;0
3869;0;65;0;0;65
3870;0;64;44;0;108
3871;126;914;44;0;1084
3872;118;764;176;0;1058
3874;55;172;44;0;271
3876;30;160;44;0;234
3877;12;72;44;0;128
3878;0;0;0;0;0
3879;0;0;0;0;0
3880;0;0;15;0;15
3881;0;0;0;0;0
3882;22;44;0;0;66
3883;60;168;44;0;272
3884;27;64;22;0;113
3885;158;636;284;0;1078
3886;225;909;602;0;1736
3887;132;558;353;0;1043
3888;182;624;176;0;982
3890;44;322;133;0;499
3891;28;126;82;0;236
3893;0;0;0;0;0
3894;0;0;44;0;44
3895;0;0;0;0;0
3896;0;0;0;0;0
3897;26;114;44;0;184
3898;0;0;44;0;44
3899;37;276;133;0;446
3900;5;0;44;0;49
3901;0;0;0;0;0
3902;0;0;0;0;0
3903;28;158;5;0;191
3904;5;38;44;0;87
3905;0;0;0;0;0
3906;0;267;44;0;311
3907;224;662;322;0;1208
3909;438;993;538;0;1969
3910;518;1746;450;0;2714
3912;34;113;40;0;187
3913;36;268;79;0;383
3914;0;108;25;0;133
3915;0;0;0;0;0
3916;17;50;45;0;112
3917;0;0;0;0;0
3918;41;74;44;0;159
3919;0;0;0;0;0
3920;2;0;22;0;24
3921;4;30;42;0;76
3922;15;78;30;0;123
3923;0;0;0;0;0
3924;0;25;0;0;25
3926;0;39;0;0;39
3927;0;0;50;0;50
3928;0;0;0;0;0
3929;0;0;0;0;0
3930;0;42;0;0;42
3931;0;0;15;0;15
3932;0;15;0;0;15
3933;0;0;0;0;0
3934;0;25;25;0;50
3935;29;72;123;0;224
3936;0;0;0;0;0
3937;0;38;25;0;63
3938;5;0;0;0;5
3940;282;728;352;0;1362
3941;177;810;238;0;1225
3943;0;0;0;0;0
3944;0;0;0;0;0
3945;0;0;8;0;8
3947;0;0;8;0;8
3948;4;0;20;0;24
3949;3;44;20;0;67
3950;0;0;0;0;0
3951;0;0;0;0;0
3952;0;0;16;0;16
3953;0;0;0;0;0
3954;0;0;0;0;0
3955;25;211;104;0;340
3957;21;106;69;0;196
3958;0;0;8;0;8
3959;0;0;0;0;0
3960;30;472;368;0;870
3961;200;882;440;0;1522
3962;8;0;0;0;8
3963;0;0;0;0;0
3964;0;0;0;0;0
3965;0;0;0;0;0
3966;27;88;0;0;115
3967;85;302;44;0;431
3968;8;30;44;0;82
3969;0;0;0;0;0
3970;0;0;0;0;0
3971;26;120;44;0;190
3972;70;230;88;0;388
3974;49;184;44;0;277
3975;15;42;44;0;101
3976;305;680;353;0;1338
3977;838;1014;396;0;2248
3978;140;397;132;0;669
3979;92;44;0;0;136
3980;244;244;132;0;620
3981;102;376;176;0;654
3982;148;164;110;0;422
3983;269;234;89;0;592
3984;97;218;128;0;443
3985;0;0;0;0;0
3986;0;0;0;0;0
3988;15;30;0;0;45
3989;15;0;0;0;15
3991;107;74;0;0;181
3992;27;20;22;0;69
3993;0;0;0;0;0
3994;0;0;0;0;0
3995;72;152;34;0;258
3996;0;0;0;0;0
3997;43;0;44;0;87
3998;86;396;242;0;724
3999;128;1032;220;0;1380
4000;0;1144;374;0;1518
4001;0;88;44;0;132
4002;80;528;220;0;828
4003;0;88;44;0;132
4004;0;0;0;0;0
4005;0;378;62;0;440
4006;0;44;44;0;88
4008;0;0;0;0;0
4009;0;0;0;0;0
4011;0;0;0;0;0
4012;0;0;0;0;0
4013;0;0;0;0;0
4014;0;0;0;0;0
4015;0;0;0;0;0
4016;0;88;44;0;132
4017;173;38;24;0;235
4018;0;0;0;0;0
4019;60;704;88;0;852
4020;0;0;0;0;0
4021;0;0;0;0;0
4022;0;4;20;0;24
4023;0;0;0;0;0
4025;304;385;176;0;865
4026;327;126;44;0;497
4027;322;164;44;0;530
4028;0;0;0;0;0
4029;303;308;132;0;743
4030;217;38;44;0;299
4031;0;0;0;0;0
4032;318;784;198;0;1300
4033;0;0;0;0;0
4034;127;56;88;0;271
4035;0;0;0;0;0
4036;0;0;0;0;0
4037;21;0;44;0;65
4039;21;0;44;0;65
4040;23;0;44;0;67
4042;0;0;0;0;0
4043;40;389;150;0;579
4044;0;0;0;0;0
4045;0;0;0;0;0
4046;0;0;0;0;0
4047;0;0;0;0;0
4048;207;1002;308;0;1517
4049;133;948;440;0;1521
4050;191;1146;396;0;1733
4051;103;250;110;0;463
4052;0;328;176;0;504
4054;0;25;0;0;25
4056;0;0;0;0;0
4057;0;0;0;0;0
4058;0;0;0;0;0
4059;30;102;110;0;242
4060;0;0;0;0;0
4061;137;170;44;0;351
4062;0;0;30;0;30
4063;0;0;0;0;0
4064;0;30;22;0;52
4065;0;0;0;0;0
4067;0;0;0;0;0
4068;0;20;0;0;20
4070;25;220;44;0;289
4071;283;668;176;0;1127
4073;0;30;22;0;52
4074;0;44;44;0;88
4075;0;0;0;0;0
4076;21;44;176;0;241
4077;6;22;0;0;28
4078;0;0;0;0;0
4079;0;0;0;0;0
4080;0;0;0;0;0
4081;3;0;0;0;3
4082;0;0;0;0;0
4083;0;0;0;0;0
4084;115;1100;264;0;1479
4085;17;66;0;0;83
4087;98;488;44;0;630
4088;2;0;0;0;2
4089;2;0;44;0;46
4090;18;176;88;0;282
4091;2;0;0;0;2
4092;2;0;0;0;2
4093;2;0;0;0;2
4094;29;0;44;0;73
4095;2;0;0;0;2
4096;33;0;30;0;63
4097;2;0;0;0;2
4098;0;0;0;0;0
4099;0;0;0;0;0
4100;3;0;0;0;3
4101;23;0;0;0;23
4102;319;1078;440;0;1837
4103;248;878;132;0;1258
4104;220;1261;264;0;1745
4106;0;0;0;0;0
4107;0;352;44;0;396
4108;0;0;0;0;0
4109;0;0;0;0;0
4110;0;0;0;0;0
4111;0;0;0;0;0
4112;0;220;88;0;308
4113;0;0;0;0;0
4114;0;0;0;0;0
4115;0;0;0;0;0
4116;0;0;0;0;0
4117;0;0;0;0;0
4118;0;0;0;0;0
4120;0;0;0;0;0
4121;0;0;0;0;0
4123;0;0;0;0;0
4124;187;698;396;0;1281
4125;36;158;88;0;282
4126;0;0;0;0;0
4127;0;0;0;0;0
4128;0;40;66;0;106
4129;0;0;0;0;0
4130;19;76;44;0;139
4131;17;38;82;0;137
4132;0;0;0;0;0
4133;0;38;44;0;82
4134;27;152;44;0;223
4135;0;0;0;0;0
4137;0;0;0;0;0
4138;0;0;0;0;0
4139;54;38;45;0;137
4140;457;1496;440;0;2393
4141;149;714;44;0;907
4142;176;40;44;0;260
4143;0;0;0;0;0
4144;0;0;0;0;0
4145;0;0;0;0;0
4146;35;240;44;0;319
4147;0;0;0;0;0
4148;0;44;0;0;44
4149;0;0;0;0;0
4150;6;50;0;0;56
4151;0;0;0;0;0
4152;0;0;0;0;0
4154;18;44;0;0;62
4155;4;44;0;0;48
4156;0;0;0;0;0
4157;0;0;0;0;0
4158;39;166;44;0;249
4159;0;0;0;0;0
4160;1028;1070;135;0;2233
4161;0;0;0;0;0
4162;352;1210;616;0;2178
4163;242;984;704;0;1930
4164;218;910;616;0;1744
4165;456;1012;792;0;2260
4166;204;704;440;0;1348
4168;158;499;264;0;921
4169;136;712;264;0;1112
4171;106;529;176;0;811
4172;102;532;264;0;898
4173;70;520;308;0;898
4174;116;998;308;0;1422
4175;126;680;352;0;1158
4176;197;588;666;0;1451
4177;56;280;88;0;424
4178;0;0;0;0;0
4179;240;1014;396;0;1650
4180;223;642;396;0;1261
4181;98;461;264;0;823
4182;0;0;0;0;0
4183;159;464;132;0;755
4185;223;748;352;0;1323
4186;58;500;352;0;910
4187;297;528;250;0;1075
4188;48;157;44;0;249
4189;116;466;132;0;714
4190;174;772;264;0;1210
4191;18;298;132;0;448
4192;0;0;0;0;0
4193;8;30;30;0;68
4194;13;171;44;0;228
4195;157;1204;352;0;1713
4196;0;0;0;0;0
4197;97;372;88;0;557
4199;200;176;74;0;450
4200;43;532;132;0;707
4201;18;248;132;0;398
4202;11;30;48;0;89
4204;0;466;132;0;598
4205;84;731;220;0;1035
4206;0;0;0;0;0
4207;11;298;88;0;397
4208;0;0;0;0;0
4209;0;0;0;0;0
4210;4;169;48;0;221
4211;0;0;0;0;0
4212;50;108;132;0;290
4213;0;0;0;0;0
4214;0;0;0;0;0
4215;0;0;0;0;0
4216;8;0;30;0;38
4218;0;0;0;0;0
4219;0;0;0;0;0
4221;12;200;44;0;256
4222;0;0;0;0;0
4223;0;0;0;0;0
4224;0;0;0;0;0
4225;0;0;0;0;0
4226;0;0;0;0;0
4227;0;0;0;0;0
4228;0;30;22;0;52
4229;0;0;0;0;0
4230;0;0;0;0;0
4231;110;44;176;0;330
4232;0;0;0;0;0
4233;0;0;0;0;0
4235;61;412;118;0;591
4236;0;0;0;0;0
4237;0;0;0;0;0
4238;0;0;0;0;0
4239;0;0;0;0;0
4240;0;0;0;0;0
4241;44;38;52;0;134
4242;0;0;0;0;0
4243;0;0;0;0;0
4244;0;0;0;0;0
4245;0;0;0;0;0
4246;0;0;0;0;0
4247;0;0;0;0;0
4249;0;0;0;0;0
4250;0;0;0;0;0
4252;0;0;0;0;0
4253;0;0;0;0;0
4254;56;28;163;0;247
4255;34;352;220;0;606
4256;0;0;0;0;0
4257;0;0;0;0;0
4258;89;380;45;0;514
4259;202;508;135;0;845
4260;4;33;60;0;97
4261;0;0;0;0;0
4262;258;840;180;0;1278
4263;163;292;315;0;770
4264;0;0;0;0;0
4266;184;457;135;0;776
4267;0;0;0;0;0
4268;158;563;165;0;886
4269;124;200;188;0;512
4270;27;360;225;0;612
4271;0;0;0;0;0
4272;26;238;90;0;354
4273;0;0;0;0;0
4274;0;0;0;0;0
4275;45;578;180;0;803
4276;0;0;0;0;0
4277;617;2786;735;0;4138
4278;0;0;0;0;0
4280;145;462;135;0;742
4281;8;42;0;0;50
4283;0;0;0;0;0
4284;69;180;90;0;339
4285;0;0;0;0;0
4286;245;0;0;0;245
4287;385;585;900;0;1870
4288;176;1033;352;0;1561
4289;219;827;970;0;2016
4290;50;372;88;0;510
4291;0;0;0;0;0
4292;94;398;88;0;580
4293;0;0;0;0;0
4294;0;10;0;0;10
4295;4;44;2;0;50
4297;4;0;20;0;24
4298;0;0;10;0;10
4299;4;0;10;0;14
4300;4;0;10;0;14
4302;0;4;10;0;14
4303;0;0;10;0;10
4304;4;0;10;0;14
4305;4;0;10;0;14
4306;4;0;20;0;24
4307;421;1398;629;0;2448
4308;249;558;180;0;987
4309;132;416;308;0;856
4310;148;640;346;0;1134
4311;0;272;69;0;341
4312;10;204;44;0;258
4313;0;0;0;0;0
4314;0;0;0;0;0
4316;0;0;0;0;0
4317;50;0;0;0;50
4319;0;0;0;0;0
4320;0;0;0;0;0
4321;0;0;0;0;0
4322;0;0;0;0;0
4323;0;0;0;0;0
4324;255;1177;308;0;1740
4325;0;0;0;0;0
4326;0;0;0;0;0
4327;35;0;30;0;65
4328;20;38;40;0;98
4330;22;68;34;0;124
4331;126;1100;308;0;1534
4333;120;610;132;0;862
4334;82;534;88;0;704
4335;3;0;0;0;3
4336;0;0;0;0;0
4337;1;0;0;0;1
4338;1;20;22;0;43
4339;1;0;0;0;1
4340;0;0;0;0;0
4341;1;0;0;0;1
4342;0;30;0;0;30
4343;0;0;0;0;0
4344;0;0;0;0;0
4345;0;22;0;0;22
4347;1;0;0;0;1
4348;8;82;0;0;90
4349;0;0;0;0;0
4350;0;45;45;0;90
4351;0;0;0;0;0
4352;205;763;132;0;1100
4353;328;490;264;0;1082
4354;102;792;264;0;1158
4355;20;196;44;0;260
4356;48;286;44;0;378
4357;35;369;170;0;574
4358;59;354;66;0;479
4359;102;206;44;0;352
4360;0;0;0;0;0
4361;78;44;40;0;162
4362;0;0;0;0;0
4364;0;0;0;0;0
4365;25;22;44;0;91
4366;0;0;0;0;0
4367;0;0;0;0;0
4368;40;184;68;0;292
4369;0;0;0;0;0
4370;0;0;0;0;0
4372;8;358;74;0;440
4373;0;0;0;0;0
4374;54;238;148;0;440
4375;50;580;352;0;982
4376;0;0;0;0;0
4378;0;0;0;0;0
4379;66;401;198;0;665
4381;24;0;180;0;204
4382;366;503;203;0;1072
4383;25;0;0;0;25
4384;0;45;179;0;224
4385;0;0;0;0;0
4386;0;45;134;0;179
4387;151;200;45;0;396
4388;0;0;0;0;0
4389;45;83;45;0;173
4390;0;0;0;0;0
4391;40;180;90;0;310
4392;52;766;154;0;972
4393;8;38;44;0;90
4395;0;0;22;0;22
4396;4;0;22;0;26
4397;0;0;0;0;0
4398;0;0;22;0;22
4399;0;0;0;0;0
4400;0;0;0;0;0
4401;0;0;0;0;0
4402;12;56;44;0;112
4403;0;0;0;0;0
4404;190;702;528;0;1420
4405;270;834;346;0;1450
4406;239;808;330;0;1377
4407;165;530;206;0;901
4408;126;352;176;0;654
4409;61;398;452;0;911
4410;201;776;201;0;1178
4411;0;0;0;0;0
4412;27;0;30;0;57
4414;18;0;40;0;58
4415;0;0;0;0;0
4416;0;0;0;0;0
4417;18;35;35;0;88
4418;0;0;0;0;0
4419;0;0;38;0;38
4420;0;0;0;0;0
4421;0;0;30;0;30
4422;0;0;0;0;0
4423;0;0;0;0;0
4424;0;0;0;0;0
4425;0;0;0;0;0
4426;0;0;74;0;74
4428;0;0;0;0;0
4429;0;0;0;0;0
4431;0;0;0;0;0
4432;14;0;35;0;49
4433;0;38;30;0;68
4434;0;0;0;0;0
4435;0;0;30;0;30
4436;0;38;30;0;68
4437;0;0;74;0;74
4438;0;0;0;0;0
4439;0;0;0;0;0
4440;0;0;0;0;0
4441;0;40;40;0;80
4442;0;0;0;0;0
4443;127;535;225;0;887
4445;0;0;0;0;0
4446;314;1282;384;0;1980
4447;114;198;84;0;396
4448;122;192;252;0;566
4449;90;234;88;0;412
4450;0;0;0;0;0
4451;178;1501;612;0;2291
4452;118;1138;412;0;1668
4453;129;794;350;0;1273
4454;303;804;360;0;1467
4455;198;1036;264;0;1498
4456;55;128;44;0;227
4457;0;0;0;0;0
4459;0;0;0;0;0
4460;0;0;0;0;0
4462;0;0;0;0;0
4463;0;0;0;0;0
4464;0;0;0;0;0
4465;0;0;0;0;0
4466;0;0;0;0;0
4467;0;0;0;0;0
4468;0;0;0;0;0
4469;0;0;0;0;0
4470;0;0;0;0;0
4471;0;0;22;0;22
4472;0;0;0;0;0
4473;0;0;0;0;0
4474;0;0;0;0;0
4476;0;0;0;0;0
4477;0;0;0;0;0
4478;0;0;0;0;0
4479;0;0;0;0;0
4480;0;45;45;0;90
4481;112;566;132;0;810
4482;245;1014;496;0;1755
4483;402;1336;1378;0;3116
4484;16;88;118;0;222
4485;28;110;88;0;226
4486;24;36;132;0;192
4487;0;0;0;0;0
4488;0;0;0;0;0
4490;0;0;0;0;0
4491;0;0;0;0;0
4493;0;0;0;0;0
4494;0;0;0;0;0
4495;7;0;69;0;76
4496;158;229;44;0;431
4497;20;88;60;0;168
4498;0;0;0;0;0
4499;0;0;0;0;0
4500;204;791;267;0;1262
4501;0;0;0;0;0
4502;0;0;0;0;0
4503;0;36;44;0;80
4504;0;0;0;0;0
4505;89;396;239;0;724
4506;286;747;220;0;1253
4507;200;646;286;0;1132
4509;158;418;88;0;664
4510;3;0;44;0;47
4512;33;140;88;0;261
4513;90;348;118;0;556
4514;39;44;74;0;157
4516;0;0;0;0;0
4517;0;6;30;0;36
4518;0;0;0;0;0
4519;0;0;0;0;0
4520;0;0;0;0;0
4521;0;0;0;0;0
4522;0;0;0;0;0
4524;0;0;0;0;0
4526;0;0;0;0;0
4527;0;43;66;0;109
4528;0;0;0;0;0
4529;0;0;0;0;0
4530;19;899;225;0;1143
4531;374;1243;775;0;2392
4532;0;0;0;0;0
4533;188;379;265;0;832
4534;220;528;1050;0;1798
4535;195;443;554;0;1192
4536;4;444;314;0;762
4537;0;0;0;0;0
4538;0;0;0;0;0
4540;72;278;114;0;464
4541;0;0;0;0;0
4543;146;613;176;0;935
4544;0;0;0;0;0
4545;0;0;0;0;0
4546;95;461;176;0;732
4547;0;0;0;0;0
4548;236;312;198;0;746
4549;0;0;0;0;0
4550;196;176;88;0;460
4551;26;0;30;0;56
4553;349;880;748;0;1977
4554;53;352;220;0;625
4555;94;875;572;0;1541
4557;152;423;264;0;839
4558;29;213;176;0;418
4559;74;264;220;0;558
4560;124;484;355;0;963
4561;44;264;264;0;572
4562;100;436;220;0;756
4563;159;220;308;0;687
4564;812;1550;616;0;2978
4565;253;598;396;0;1247
4566;0;0;0;0;0
4567;0;0;0;0;0
4568;0;0;0;0;0
4569;101;408;360;0;869
4570;0;0;0;0;0
4571;211;567;487;0;1265
4572;238;572;432;0;1242
4574;638;875;396;0;1909
4575;219;767;354;0;1340
4576;148;591;177;0;916
4577;131;316;308;0;755
4578;95;782;132;0;1009
4579;222;336;220;0;778
4580;0;0;0;0;0
4581;88;176;346;0;610
4582;119;168;176;0;463
4583;0;0;0;0;0
4584;75;393;256;0;724
4585;207;364;370;0;941
4586;101;334;267;0;702
4588;301;894;484;0;1679
4589;383;176;250;0;809
4591;211;1205;308;0;1724
4592;106;374;176;0;656
4593;146;466;214;0;826
4594;362;858;334;0;1554
4595;194;803;176;0;1173
4596;0;0;0;0;0
4597;40;269;44;0;353
4598;0;0;0;0;0
4599;0;0;0;0;0
4600;0;0;0;0;0
4601;0;0;0;0;0
4602;0;0;0;0;0
4603;124;118;132;0;374
4604;0;0;0;0;0
4605;0;0;0;0;0
4607;0;0;0;0;0
4608;0;0;0;0;0
4609;84;324;220;0;628
4610;0;0;0;0;0
4611;78;436;88;0;602
4612;154;124;177;0;455
4613;84;176;176;0;436
4614;112;342;176;0;630
4615;104;677;352;0;1133
4616;168;770;264;0;1202
4617;690;162;176;0;1028
4618;0;0;0;0;0
4619;0;0;0;0;0
4620;0;0;0;0;0
4621;0;0;0;0;0
4622;42;174;132;0;348
4625;0;0;0;0;0
4626;115;419;295;0;829
4627;67;194;255;0;516
4628;16;180;230;0;426
4629;113;549;245;0;907
4630;516;1034;923;0;2473
4631;659;1210;495;0;2364
4632;0;0;0;0;0
4633;16;135;120;0;271
4634;0;0;0;0;0
4635;115;90;125;0;330
4636;187;293;270;0;750
4638;84;134;45;0;263
4639;8;0;0;0;8
4641;45;369;135;0;549
4642;0;0;0;0;0
4643;0;0;0;0;0
4644;369;827;495;0;1691
4645;22;171;104;0;297
4646;240;360;630;0;1230
4647;45;112;134;0;291
4648;103;0;135;0;238
4649;70;347;180;0;597
4650;117;500;116;0;733
4651;0;0;0;0;0
4652;0;0;0;0;0
4653;0;0;0;0;0
4655;67;360;180;0;607
4656;113;134;420;0;667
4657;0;0;0;0;0
4658;219;464;248;0;931
4659;183;853;405;0;1441
4660;147;275;196;0;618
4661;0;0;0;0;0
4662;603;1766;765;0;3134
4663;221;1632;855;0;2708
4664;224;881;405;0;1510
4665;118;188;95;0;401
4666;245;490;484;0;1219
4667;65;724;265;0;1054
4669;234;1041;492;0;1767
4670;55;97;29;0;181
4672;364;175;450;0;989
4673;0;0;0;0;0
4675;154;270;178;0;602
4677;81;583;90;0;754
4679;0;0;0;0;0
4680;0;0;0;0;0
4681;0;0;0;0;0
4682;0;0;0;0;0
4683;0;0;0;0;0
4684;0;0;0;0;0
4686;537;347;487;0;1371
4687;482;264;753;0;1499
4688;0;0;0;0;0
4689;44;0;0;0;44
4690;0;0;0;0;0
4691;59;505;270;0;834
4692;0;0;0;0;0
4693;0;0;0;0;0
4694;0;0;0;0;0
4695;0;0;0;0;0
4696;0;0;0;0;0
4697;0;0;0;0;0
4698;89;498;315;0;902
4700;130;311;315;0;756
4701;0;0;0;0;0
4702;342;836;840;0;2018
4703;242;510;356;0;1108
4705;0;0;0;0;0
4706;103;435;398;0;936
4707;292;866;443;0;1601
4708;175;528;309;0;1012
4709;479;1012;354;0;1845
4710;0;0;0;0;0
4711;342;392;132;0;866
4712;227;592;221;0;1040
4713;148;954;308;0;1410
4714;207;326;338;0;871
4715;74;308;268;0;650
4716;0;0;0;0;0
4717;179;235;352;0;766
4719;154;427;264;0;845
4720;183;60;262;0;505
4722;669;440;352;0;1461
4723;151;570;177;0;898
4724;365;455;176;0;996
4725;91;266;221;0;578
4726;169;210;179;0;558
4727;130;297;199;0;626
4728;253;883;176;0;1312
4729;0;0;0;0;0
4730;132;638;308;0;1078
4731;155;208;176;0;539
4732;97;508;265;0;870
4733;287;236;176;0;699
4734;276;436;266;0;978
4736;469;363;176;0;1008
4737;618;570;529;0;1717
4738;0;0;0;0;0
4739;0;0;0;0;0
4740;0;88;132;0;220
4741;0;74;109;0;183
4742;353;460;132;0;945
4743;0;0;0;0;0
4744;170;240;133;0;543
4745;0;0;0;0;0
4746;214;134;207;0;555
4747;207;164;326;0;697
4748;131;32;88;0;251
4750;110;338;132;0;580
4751;114;304;88;0;506
4753;346;0;92;0;438
4754;701;821;178;0;1700
4755;0;0;0;0;0
4756;0;0;0;0;0
4757;0;0;0;0;0
4758;40;0;45;0;85
4759;0;0;0;0;0
4760;246;301;67;0;614
4761;0;0;0;0;0
4762;1671;526;1192;0;3389
4764;0;0;0;0;0
4765;0;0;0;0;0
4767;138;370;120;0;628
4768;158;393;45;0;596
4769;0;0;0;0;0
4770;0;0;0;0;0
4771;0;0;0;0;0
4772;341;1207;225;0;1773
4773;0;0;0;0;0
4774;72;69;90;0;231
4775;0;0;0;0;0
4776;0;0;0;0;0
4777;5;20;35;0;60
4778;203;489;190;0;882
4779;43;747;260;0;1050
4780;0;0;0;0;0
4781;126;165;134;0;425
4782;599;355;1140;0;2094
4784;0;0;0;0;0
4785;651;0;315;0;966
4786;45;241;225;0;511
4787;0;0;0;0;0
4788;0;0;0;0;0
4789;0;0;0;0;0
4790;127;681;315;0;1123
4791;35;20;23;0;78
4792;85;137;48;0;270
4793;0;0;0;0;0
4794;0;0;0;0;0
4795;0;0;0;0;0
4796;0;495;0;0;495
4798;0;0;0;0;0
4799;0;0;0;0;0
4803;155;169;88;0;412
4804;0;0;0;0;0
4805;132;358;266;0;756
4806;33;246;176;0;455
4807;132;296;132;0;560
4808;44;362;177;0;583
4809;174;88;132;0;394
4810;78;217;221;0;516
4811;80;302;177;0;559
4812;86;84;132;0;302
4813;30;118;44;0;192
4814;0;88;132;0;220
4815;0;0;0;0;0
4817;10;0;44;0;54
4818;203;270;135;0;608
4819;0;0;0;0;0
4820;73;22;96;0;191
4821;0;0;0;0;0
4822;94;707;90;0;891
4823;0;0;0;0;0
4824;60;451;688;0;1199
4825;154;700;308;0;1162
4827;192;97;82;0;371
4828;0;0;0;0;0
4829;531;889;484;0;1904
4830;407;1315;490;0;2212
4831;233;354;176;0;763
4832;209;88;132;0;429
4834;828;454;176;0;1458
4835;241;830;255;0;1326
4836;188;234;170;0;592
4837;141;314;364;0;819
4838;301;137;88;0;526
4839;169;246;44;0;459
4840;282;0;108;0;390
4841;107;520;126;0;753
4842;227;228;132;0;587
4843;278;85;196;0;559
4844;18;0;44;0;62
4845;74;325;132;0;531
4846;0;0;0;0;0
4848;218;82;88;0;388
4849;0;0;0;0;0
4851;10;0;0;0;10
4852;42;124;44;0;210
4853;0;0;0;0;0
4854;16;0;44;0;60
4855;35;40;124;0;199
4856;0;0;0;0;0
4857;0;0;0;0;0
4858;13;5;0;0;18
4859;10;0;0;0;10
4860;78;16;44;0;138
4861;15;0;0;0;15
4862;0;0;0;0;0
4863;0;0;0;0;0
4865;229;644;385;0;1258
4866;191;414;222;0;827
4867;0;20;9;0;29
4868;278;116;350;0;744
4869;105;650;176;0;931
4870;25;660;264;0;949
4871;104;312;176;0;592
4873;106;243;66;0;415
4874;0;0;0;0;0
4875;0;20;22;0;42
4876;0;0;0;0;0
4877;0;0;82;0;82
4879;0;36;44;0;80
4880;0;0;0;0;0
4882;0;22;44;0;66
4883;0;0;0;0;0
4884;0;0;0;0;0
4885;0;0;0;0;0
4886;0;0;22;0;22
4887;0;0;22;0;22
4888;0;0;0;0;0
4889;0;0;22;0;22
4890;76;153;66;0;295
4891;0;0;22;0;22
4892;0;0;0;0;0
4893;0;0;0;0;0
4894;24;90;45;0;159
4896;27;48;112;0;187
4897;297;696;440;0;1433
4898;236;995;440;0;1671
4899;0;0;0;0;0
4901;6;0;0;0;6
4902;408;258;308;0;974
4903;2;0;0;0;2
4904;8;0;0;0;8
4905;0;0;0;0;0
4906;6;38;0;0;44
4907;0;0;0;0;0
4908;52;252;44;0;348
4909;41;44;91;0;176
4910;8;0;0;0;8
4911;6;0;0;0;6
4912;2;0;0;0;2
4913;29;0;0;0;29
4915;74;6;44;0;124
4916;0;0;0;0;0
4917;6;0;0;0;6
4918;18;0;88;0;106
4920;6;0;44;0;50
4921;0;0;0;0;0
4922;188;289;313;0;790
4923;0;0;0;0;0
4924;0;0;0;0;0
4925;233;1100;460;0;1793
4926;72;313;132;0;517
4927;4;118;88;0;210
4929;0;0;40;0;40
4930;0;0;0;0;0
4932;0;44;44;0;88
4933;0;0;0;0;0
4934;0;0;0;0;0
4935;0;0;0;0;0
4936;0;0;0;0;0
4937;0;0;0;0;0
4938;0;0;0;0;0
4939;0;0;0;0;0
4940;0;0;44;0;44
4941;0;0;0;0;0
4942;0;0;44;0;44
4943;6;64;132;0;202
4944;0;0;0;0;0
4946;4;44;44;0;92
4947;112;695;278;0;1085
4948;184;792;616;0;1592
4949;220;715;484;0;1419
4950;145;480;245;0;870
4951;200;1120;836;0;2156
4952;220;1350;616;0;2186
4953;114;944;572;0;1630
4954;529;484;220;0;1233
4955;105;592;220;0;917
4956;703;836;352;0;1891
4957;0;0;0;0;0
4958;527;802;440;0;1769
4960;480;1356;440;0;2276
4961;232;528;176;0;936
4963;0;0;0;0;0
4964;0;0;0;0;0
4965;232;420;352;0;1004
4966;0;0;0;0;0
4967;273;1130;264;0;1667
4968;139;475;264;0;878
4969;54;135;145;0;334
4970;193;869;245;0;1307
4971;7;172;90;0;269
4973;100;1120;465;0;1685
4974;109;70;110;0;289
4975;254;88;314;0;656
4977;505;754;450;0;1709
4978;0;0;0;0;0
4979;120;270;220;0;610
4980;0;0;0;0;0
4981;0;0;0;0;0
4982;477;792;792;0;2061
4983;238;359;352;0;949
4984;436;410;308;0;1154
4985;229;264;132;0;625
4986;119;88;218;0;425
4987;255;264;176;0;695
4988;275;869;220;0;1364
4989;233;588;220;0;1041
4990;230;308;264;0;802
4991;189;235;220;0;644
4992;114;484;220;0;818
4994;217;470;308;0;995
4995;358;444;352;0;1154
4996;291;256;176;0;723
4997;544;264;220;0;1028
4998;48;396;88;0;532
4999;156;384;88;0;628
5001;382;1156;484;0;2022
5002;81;126;252;0;459
5003;81;286;88;0;455
5004;0;0;0;0;0
5005;132;660;352;0;1144
5006;3;0;88;0;91
5007;0;0;0;0;0
5008;0;0;0;0;0
5009;100;348;135;0;583
5010;99;770;135;0;1004
5011;0;0;0;0;0
5012;165;327;205;0;697
5014;0;0;0;0;0
5015;101;330;90;0;521
5016;235;450;495;0;1180
5018;0;0;0;0;0
5019;145;631;225;0;1001
5020;260;545;135;0;940
5021;382;1262;744;0;2388
5022;68;352;132;0;552
5023;0;0;0;0;0
5024;149;795;352;0;1296
5025;374;1151;220;0;1745
5026;388;1277;440;0;2105
5028;84;484;132;0;700
5029;228;716;220;0;1164
5031;314;181;118;0;613
5032;0;0;0;0;0
5033;336;537;132;0;1005
5034;138;799;132;0;1069
5035;0;44;88;0;132
5036;0;16;0;0;16
5037;0;0;0;0;0
5038;76;343;132;0;551
5039;104;598;132;0;834
5040;0;16;0;0;16
5041;0;0;0;0;0
5042;0;0;0;0;0
5043;0;0;0;0;0
5045;0;0;0;0;0
5046;30;335;135;0;500
5047;0;0;0;0;0
5048;260;850;352;0;1462
5049;93;696;132;0;921
5050;198;888;176;0;1262
5051;102;790;88;0;980
5052;48;301;132;0;481
5053;65;246;88;0;399
5054;62;539;162;0;763
5055;52;316;88;0;456
5056;4;0;0;0;4
5057;87;200;132;0;419
5059;0;0;0;0;0
5060;0;0;0;0;0
5062;0;0;0;0;0
5063;0;0;0;0;0
5064;0;0;0;0;0
5065;4;44;0;0;48
5066;0;0;0;0;0
5067;0;0;0;0;0
5068;0;0;0;0;0
5069;16;0;44;0;60
5070;6;0;44;0;50
5071;0;0;0;0;0
5072;41;310;44;0;395
5073;160;546;264;0;970
5074;57;232;88;0;377
5076;0;0;0;0;0
5077;0;0;0;0;0
5078;0;0;0;0;0
5079;0;0;0;0;0
5080;0;0;0;0;0
5081;0;0;0;0;0
5082;345;1179;400;0;1924
5083;217;200;255;0;672
5084;514;1574;782;0;2870
5085;211;1582;308;0;2101
5086;40;158;0;0;198
5087;92;751;44;0;887
5088;353;1609;558;0;2520
5090;76;644;82;0;802
5091;203;176;44;0;423
5093;224;590;88;0;902
5094;90;334;44;0;468
5095;0;0;30;0;30
5096;0;0;0;0;0
5097;0;40;0;0;40
5098;0;0;0;0;0
5099;0;0;0;0;0
5100;0;0;0;0;0
5101;42;410;0;0;452
5102;0;0;0;0;0
5103;0;0;0;0;0
5104;315;888;400;0;1603
5105;259;598;484;0;1341
5106;160;660;309;0;1129
5107;44;384;90;0;518
5109;244;722;220;0;1186
5110;102;291;221;0;614
5112;125;391;88;0;604
5113;110;168;113;0;391
5114;0;0;0;0;0
5115;0;0;0;0;0
5116;25;0;110;0;135
5117;0;0;0;0;0
5118;0;0;0;0;0
5119;58;148;89;0;295
5120;0;0;0;0;0
5121;58;204;135;0;397
5122;474;1483;581;0;2538
5123;70;421;0;0;491
5124;0;0;0;0;0
5126;132;822;396;0;1350
5127;310;566;88;0;964
5128;122;618;176;0;916
5129;78;740;176;0;994
5130;123;608;176;0;907
5131;210;298;176;0;684
5132;66;436;88;0;590
5133;49;74;88;0;211
5134;96;204;88;0;388
5135;20;0;44;0;64
5136;0;0;0;0;0
5137;0;0;0;0;0
5138;0;0;0;0;0
5140;24;103;88;0;215
5141;0;0;0;0;0
5143;10;88;0;0;98
5144;0;0;0;0;0
5145;8;0;44;0;52
5146;0;0;0;0;0
5147;71;112;44;0;227
5148;0;0;0;0;0
5149;0;0;0;0;0
5150;478;1258;630;0;2366
5151;74;350;0;0;424
5152;161;135;90;0;386
5153;225;504;315;0;1044
5154;162;1198;176;0;1536
5155;74;676;44;0;794
5157;39;89;132;0;260
5158;49;144;172;0;365
5159;44;0;0;0;44
5160;0;0;0;0;0
5162;0;44;0;0;44
5163;0;0;0;0;0
5164;0;0;0;0;0
5165;0;36;0;0;36
5166;58;388;44;0;490
5167;0;0;0;0;0
5168;0;0;0;0;0
5169;0;0;0;0;0
5170;0;36;0;0;36
5171;0;0;0;0;0
5172;29;116;44;0;189
5174;0;0;0;0;0
5175;36;0;0;0;36
5176;0;0;0;0;0
5177;0;0;0;0;0
5178;14;189;132;0;335
5179;0;0;0;0;0
5180;31;365;104;0;500
5181;112;45;180;0;337
5182;4;44;5;0;53
5183;0;0;0;0;0
5184;0;0;0;0;0
5186;0;0;32;0;32
5188;40;44;44;0;128
5189;110;0;228;0;338
5191;0;0;0;0;0
5192;61;197;132;0;390
5193;150;431;88;0;669
5194;97;637;220;0;954
5195;0;0;0;0;0
5196;76;325;88;0;489
5197;79;213;88;0;380
5198;0;0;0;0;0
5199;0;0;0;0;0
5200;0;0;0;0;0
5201;0;0;44;0;44
5202;220;236;44;0;500
5203;0;44;44;0;88
5204;0;0;44;0;44
5205;52;47;44;0;143
5207;4;44;0;0;48
5208;46;236;80;0;362
5209;0;0;0;0;0
5210;57;133;90;0;280
5211;102;449;90;0;641
5212;16;184;90;0;290
5213;0;67;0;0;67
5214;78;215;135;0;428
5215;0;477;400;0;877
5216;206;690;264;0;1160
5217;0;0;0;0;0
5218;88;836;435;0;1359
5219;57;1491;748;0;2296
5220;261;607;382;0;1250
5221;322;489;176;0;987
5224;134;892;226;0;1252
5225;256;499;264;0;1019
5226;440;2010;506;0;2956
5227;174;882;132;0;1188
5228;145;795;264;0;1204
5229;446;1668;440;0;2554
5230;108;260;88;0;456
5231;0;0;0;0;0
5232;0;0;0;0;0
5233;0;126;44;0;170
5234;0;0;0;0;0
5235;0;0;0;0;0
5236;0;0;0;0;0
5238;0;0;0;0;0
5241;0;0;0;0;0
5242;0;0;0;0;0
5243;0;0;0;0;0
5244;0;0;0;0;0
5245;0;0;0;0;0
5246;0;0;0;0;0
5247;0;0;0;0;0
5248;35;0;88;0;123
5249;54;316;132;0;502
5250;16;160;44;0;220
5251;0;0;0;0;0
5252;0;0;0;0;0
5255;0;0;0;0;0
5256;0;0;0;0;0
5257;0;0;0;0;0
5258;0;0;10;0;10
5261;0;0;0;0;0
5262;0;0;0;0;0
5263;0;0;0;0;0
5264;349;1297;630;0;2276
5265;50;1006;135;0;1191
5266;0;360;90;0;450
5267;143;950;45;0;1138
5269;0;0;0;0;0
5270;192;886;264;0;1342
5272;196;462;220;0;878
5273;64;806;176;0;1046
5274;123;484;264;0;871
5275;0;44;0;0;44
5276;0;74;44;0;118
5277;0;0;0;0;0
5278;0;0;0;0;0
5279;0;0;0;0;0
5280;190;706;225;0;1121
5281;0;0;0;0;0
5282;202;1417;348;0;1967
5283;221;970;242;0;1433
5284;192;692;132;0;1016
5286;241;817;246;0;1304
5287;0;0;0;0;0
5288;148;764;106;0;1018
5289;308;876;240;0;1424
5290;127;262;88;0;477
5291;0;0;0;0;0
5292;176;742;176;0;1094
5294;26;51;44;0;121
5295;0;0;0;0;0
5296;0;0;0;0;0
5297;0;0;44;0;44
5298;0;0;0;0;0
5300;0;0;0;0;0
5305;0;0;0;0;0
5306;0;0;0;0;0
5307;3;8;44;0;55
5308;0;0;0;0;0
5309;15;52;44;0;111
5310;7;7;44;0;58
5311;0;0;0;0;0
5312;0;0;0;0;0
5314;5;8;44;0;57
5315;155;1363;495;0;2013
5317;0;0;0;0;0
5319;0;0;0;0;0
5320;0;0;0;0;0
5322;0;24;0;0;24
5323;344;704;352;0;1400
5324;230;992;352;0;1574
5325;0;0;0;0;0
5326;80;172;176;0;428
5327;68;220;132;0;420
5328;0;0;0;0;0
5329;29;44;44;0;117
5330;0;0;0;0;0
5331;8;0;132;0;140
5332;0;0;44;0;44
5333;101;382;88;0;571
5336;4;0;44;0;48
5337;0;0;0;0;0
5338;52;352;44;0;448
5339;70;240;132;0;442
5340;0;0;22;0;22
5341;49;44;44;0;137
5342;114;670;247;0;1031
5343;45;717;314;0;1076
5344;609;1476;682;0;2767
5345;59;366;118;0;543
5346;80;105;132;0;317
5347;247;852;44;0;1143
5348;36;0;44;0;80
5350;207;0;44;0;251
5351;0;0;0;0;0
5353;129;44;282;0;455
5354;0;0;0;0;0
5357;0;0;0;0;0
5358;0;0;0;0;0
5359;0;0;0;0;0
5360;0;0;0;0;0
5362;0;0;0;0;0
5363;0;177;44;0;221
5364;0;0;0;0;0
5365;0;0;0;0;0
5367;0;0;0;0;0
5368;0;0;0;0;0
5371;0;0;44;0;44
5372;287;785;178;0;1250
5373;46;192;128;0;366
5374;154;714;220;0;1088
5375;151;0;176;0;327
5376;0;0;89;0;89
5378;109;126;132;0;367
5379;0;76;0;0;76
5380;0;0;0;0;0
5381;0;0;0;0;0
5382;87;170;88;0;345
5384;0;0;0;0;0
5385;44;152;44;0;240
5386;0;84;0;0;84
5387;178;492;300;0;970
5388;0;0;0;0;0
5389;0;0;2;0;2
5390;0;0;0;0;0
5391;40;0;53;0;93
5392;10;55;89;0;154
5393;466;1246;396;0;2108
5394;347;993;572;0;1912
5395;376;999;264;0;1639
5396;162;425;176;0;763
5398;166;520;198;0;884
5400;0;0;0;0;0
5401;104;258;88;0;450
5403;0;0;0;0;0
5404;99;72;44;0;215
5405;0;0;0;0;0
5406;184;269;132;0;585
5407;32;328;132;0;492
5408;61;197;88;0;346
5409;0;0;0;0;0
5410;0;0;44;0;44
5411;176;426;44;0;646
5412;0;0;0;0;0
5413;0;0;0;0;0
5414;44;52;44;0;140
5415;0;0;0;0;0
5418;0;0;0;0;0
5419;0;0;0;0;0
5420;0;0;0;0;0
5421;0;0;0;0;0
5422;71;60;44;0;175
5423;44;44;0;0;88
5424;10;12;44;0;66
5425;79;74;44;0;197
5426;0;0;0;0;0
5427;0;0;0;0;0
5428;0;0;0;0;0
5429;0;0;0;0;0
5430;46;0;44;0;90
5431;2;50;44;0;96
5432;0;0;0;0;0
5434;178;522;405;0;1105
5435;169;796;360;0;1325
5436;0;0;10;0;10
5437;8;44;44;0;96
5439;352;508;352;0;1212
5440;138;748;440;0;1326
5441;176;1458;220;0;1854
5442;172;1526;206;0;1904
5443;0;0;0;0;0
5444;0;0;0;0;0
5446;110;606;176;0;892
5448;0;0;0;0;0
5449;0;44;44;0;88
5452;0;0;0;0;0
5453;0;0;0;0;0
5454;0;0;0;0;0
5455;0;44;44;0;88
5456;0;0;0;0;0
5457;0;0;0;0;0
5458;0;0;0;0;0
5459;0;44;0;0;44
5460;0;0;0;0;0
5461;0;0;0;0;0
5462;0;22;0;0;22
5463;22;44;44;0;110
5465;405;1386;180;0;1971
5466;57;543;88;0;688
5467;141;515;735;0;1391
5468;0;0;0;0;0
5469;0;0;0;0;0
5470;118;984;220;0;1322
5471;226;1276;308;0;1810
5472;52;352;220;0;624
5473;20;60;0;0;80
5474;0;0;0;0;0
5475;0;0;0;0;0
5476;0;0;0;0;0
5477;0;0;0;0;0
5479;0;44;44;0;88
5480;0;10;44;0;54
5482;0;16;44;0;60
5483;0;0;0;0;0
5484;0;0;0;0;0
5485;0;44;44;0;88
5486;0;0;0;0;0
5487;0;88;0;0;88
5488;0;0;0;0;0
5489;0;0;0;0;0
5490;0;0;0;0;0
5492;0;74;0;0;74
5493;16;0;45;0;61
5494;0;34;0;0;34
5496;0;15;0;0;15
5498;0;0;0;0;0
5499;90;178;80;0;348
5502;0;0;0;0;0
5503;0;0;12;0;12
5504;0;45;22;0;67
5505;0;0;0;0;0
5506;0;80;0;0;80
5507;206;298;264;0;768
5508;419;1030;308;0;1757
5509;174;494;440;0;1108
5510;270;504;466;0;1240
5511;0;0;0;0;0
5512;0;0;0;0;0
5513;0;0;44;0;44
5515;0;0;0;0;0
5516;0;0;0;0;0
5517;0;0;0;0;0
5518;0;0;0;0;0
5519;0;0;0;0;0
5520;0;0;0;0;0
5521;8;0;0;0;8
5522;0;44;0;0;44
5523;0;0;0;0;0
5524;8;0;0;0;8
5525;27;176;88;0;291
5526;0;0;0;0;0
5527;0;0;0;0;0
5529;0;0;0;0;0
5530;0;0;0;0;0
5532;18;0;0;0;18
5533;0;0;0;0;0
5534;0;0;0;0;0
5535;0;30;0;0;30
5536;30;30;0;0;60
5537;44;44;44;0;132
5538;124;1070;30;0;1224
5539;87;414;176;0;677
5541;18;148;88;0;254
5542;0;32;0;0;32
5543;0;0;0;0;0
5544;0;0;0;0;0
5546;0;0;0;0;0
5548;0;6;20;0;26
5550;0;53;22;0;75
5551;0;24;0;0;24
5552;0;0;0;0;0
5553;0;0;0;0;0
5554;0;0;0;0;0
5555;0;0;0;0;0
5556;0;0;0;0;0
5557;0;0;0;0;0
5558;0;18;0;0;18
5560;0;0;0;0;0
5561;0;0;0;0;0
5563;0;9;0;0;9
5564;0;0;0;0;0
5565;238;387;308;0;933
5566;135;810;30;0;975
5567;30;376;176;0;582
5568;140;610;440;0;1190
5569;261;970;528;0;1759
5570;800;1819;1188;0;3807
5571;0;0;0;0;0
5574;199;271;319;0;789
5575;196;520;162;0;878
5577;0;0;0;0;0
5578;584;1603;558;0;2745
5579;0;0;0;0;0
5580;508;1379;440;0;2327
5581;0;0;0;0;0
5582;440;467;220;0;1127
5583;361;686;176;0;1223
5584;0;0;0;0;0
5585;262;265;198;0;725
5586;0;0;0;0;0
5587;0;0;0;0;0
5588;441;176;398;0;1015
5589;187;603;250;0;1040
5590;314;510;176;0;1000
5591;0;0;0;0;0
5592;330;223;244;0;797
5594;0;0;0;0;0
5595;0;0;0;0;0
5596;553;636;1404;0;2593
5597;212;1108;352;0;1672
5598;192;962;264;0;1418
5599;190;236;264;0;690
5600;110;0;22;0;132
5601;137;210;88;0;435
5602;0;0;0;0;0
5603;102;396;88;0;586
5604;86;470;132;0;688
5605;0;0;0;0;0
5606;123;862;308;0;1293
5607;0;0;0;0;0
5608;158;232;214;0;604
5611;323;934;220;0;1477
5613;212;1026;396;0;1634
5614;237;434;176;0;847
5617;36;336;44;0;416
5619;116;159;44;0;319
5620;24;220;88;0;332
5622;132;264;220;0;616
5623;36;25;44;0;105
5624;107;120;232;0;459
5625;75;164;132;0;371
5627;27;35;69;0;131
5629;18;4;44;0;66
5630;24;120;44;0;188
5631;21;69;95;0;185
5632;24;61;44;0;129
5633;11;30;44;0;85
5634;55;78;151;0;284
5635;47;0;73;0;120
5636;8;12;44;0;64
5637;14;0;44;0;58
5638;38;25;44;0;107
5639;0;0;44;0;44
5640;126;254;44;0;424
5641;0;0;0;0;0
5644;8;4;44;0;56
5645;219;631;176;0;1026
5646;82;8;69;0;159
5647;76;30;44;0;150
5648;33;84;44;0;161
5649;90;148;113;0;351
5651;0;0;3;0;3
5652;308;785;635;0;1728
5653;0;135;180;0;315
5654;1237;3271;1570;0;6078
5655;178;405;135;0;718
5656;305;782;290;0;1377
5658;135;134;90;0;359
5659;62;516;530;0;1108
5661;163;1332;315;0;1810
5662;0;205;135;0;340
5663;227;1088;451;0;1766
5664;136;243;200;0;579
5665;45;746;90;0;881
5666;413;597;225;0;1235
5667;90;659;128;0;877
5668;157;255;204;0;616
5669;255;733;265;0;1253
5670;181;804;450;0;1435
5675;0;118;30;0;148
5677;38;270;45;0;353
5678;0;509;185;0;694
5680;120;660;426;0;1206
5681;0;0;0;0;0
5682;149;430;225;0;804
5683;123;151;108;0;382
5684;20;115;50;0;185
5686;0;15;45;0;60
5690;84;277;60;0;421
5693;20;60;45;0;125
5694;0;90;45;0;135
5695;250;203;151;0;604
5697;45;410;339;0;794
5698;98;108;135;0;341
5700;0;0;0;0;0
5701;0;0;0;0;0
5703;329;655;180;0;1164
5705;0;0;0;0;0
5706;281;338;220;0;839
5709;192;114;90;0;396
5711;0;0;0;0;0
5713;263;368;74;0;705
5714;15;80;134;0;229
5716;50;210;270;0;530
5717;35;767;382;0;1184
5718;0;0;0;0;0
5719;208;737;135;0;1080
5720;168;376;515;0;1059
5722;0;72;109;0;181
5723;0;0;0;0;0
5725;245;574;265;0;1084
5726;62;313;180;0;555
5729;104;265;225;0;594
5730;68;151;115;0;334
5731;19;82;35;0;136
5732;24;0;197;0;221
5733;0;0;0;0;0
5734;8;0;2;0;10
5736;0;0;0;0;0
5737;24;174;45;0;243
5739;0;25;10;0;35
5740;0;12;90;0;102
5742;0;0;0;0;0
5744;0;0;0;0;0
5745;28;38;70;0;136
5746;0;405;260;0;665
5747;0;0;90;0;90
5748;12;91;0;0;103
5750;8;8;25;0;41
5751;29;92;0;0;121
5752;0;6;35;0;41
5753;18;79;90;0;187
5754;52;55;0;0;107
5756;0;32;30;0;62
5759;0;44;44;0;88
5760;0;0;98;0;98
5761;28;74;104;0;206
5763;46;240;64;0;350
5764;27;45;45;0;117
5765;0;20;88;0;108
5766;95;37;45;0;177
5767;47;94;97;0;238
5768;8;40;0;0;48
5770;21;30;0;0;51
5773;22;74;45;0;141
5774;164;88;126;0;378
5776;27;0;20;0;47
5778;0;0;90;0;90
5779;0;0;45;0;45
5781;30;38;60;0;128
5782;65;520;239;0;824
5783;20;0;4;0;24
5784;0;45;45;0;90
5785;0;0;45;0;45
5787;0;0;0;0;0
5790;34;44;114;0;192
5791;19;0;50;0;69
5792;0;0;0;0;0
5793;0;90;90;0;180
5794;0;42;97;0;139
5796;16;0;202;0;218
5797;17;39;11;0;67
5798;16;35;44;0;95
5799;0;2;39;0;41
5800;0;79;0;0;79
5801;0;23;45;0;68
5803;0;75;45;0;120
5804;0;0;0;0;0
5806;45;0;0;0;45
5807;0;10;10;0;20
5808;89;579;360;0;1028
5810;0;0;0;0;0
5812;0;0;0;0;0
5813;583;808;856;0;2247
5814;248;908;260;0;1416
5815;0;0;0;0;0
5816;172;88;704;0;964
5817;0;0;0;0;0
5820;0;0;0;0;0
5823;392;1116;352;0;1860
5824;466;958;176;0;1600
5825;223;426;220;0;869
5827;311;288;176;0;775
5828;440;307;744;0;1491
5829;256;1248;220;0;1724
5830;0;0;0;0;0
5831;206;462;162;0;830
5832;111;323;44;0;478
5833;134;88;44;0;266
5834;0;44;22;0;66
5835;0;44;44;0;88
5837;0;0;0;0;0
5838;0;0;44;0;44
5839;0;0;0;0;0
5840;0;0;0;0;0
5841;0;0;0;0;0
5843;0;0;0;0;0
5844;0;0;0;0;0
5846;0;44;44;0;88
5847;20;0;132;0;152
5848;0;0;0;0;0
5849;0;88;0;0;88
5850;0;0;0;0;0
5851;0;88;22;0;110
5852;0;44;44;0;88
5854;108;228;44;0;380
5855;0;88;44;0;132
5856;0;0;0;0;0
5857;0;0;0;0;0
5858;0;0;0;0;0
5859;0;0;0;0;0
5861;124;946;549;0;1619
5862;186;279;310;0;775
5863;0;0;0;0;0
5868;0;135;112;0;247
5869;46;172;60;0;278
5871;0;0;119;0;119
5872;0;123;45;0;168
5873;16;38;45;0;99
5875;40;152;40;0;232
5876;18;64;44;0;126
5877;0;0;0;0;0
5878;16;257;45;0;318
5879;192;390;264;0;846
5880;316;764;220;0;1300
5881;0;0;0;0;0
5882;0;0;0;0;0
5885;66;132;88;0;286
5886;0;0;0;0;0
5887;0;0;0;0;0
5888;110;132;132;0;374
5889;0;0;0;0;0
5890;0;0;0;0;0
5891;0;0;0;0;0
5893;6;0;45;0;51
5894;92;294;72;0;458
5896;44;386;0;0;430
5897;282;1157;176;0;1615
5899;54;162;80;0;296
5900;0;0;0;0;0
5901;44;235;44;0;323
5902;146;178;130;0;454
5905;38;74;44;0;156
5909;0;0;0;0;0
5910;0;0;0;0;0
5911;0;0;127;0;127
5912;0;0;0;0;0
5913;0;0;0;0;0
5914;0;0;0;0;0
5915;0;0;0;0;0
5919;89;340;45;0;474
5921;45;779;339;0;1163
5922;0;0;0;0;0
5923;40;310;225;0;575
5924;0;0;0;0;0
5925;0;0;0;0;0
5926;0;0;0;0;0
5927;9;16;10;0;35
5928;0;0;0;0;0
5930;0;30;10;0;40
5931;0;0;0;0;0
5932;0;0;0;0;0
5933;0;0;10;0;10
5935;0;157;30;0;187
5936;0;0;0;0;0
5938;63;145;38;0;246
5939;0;0;0;0;0
5940;52;450;405;0;907
5942;0;142;39;0;181
5943;0;0;0;0;0
5945;2;0;6;0;8
5946;0;0;0;0;0
5947;0;37;0;0;37
5952;32;218;45;0;295
5954;61;89;0;0;150
5955;109;252;45;0;406
5957;214;994;434;0;1642
5959;362;567;220;0;1149
5960;72;322;150;0;544
5961;0;0;0;0;0
5962;14;0;0;0;14
5963;0;44;0;0;44
5964;0;0;0;0;0
5967;0;0;0;0;0
5968;0;0;0;0;0
5970;34;155;44;0;233
5972;0;0;0;0;0
5973;49;0;44;0;93
5974;0;0;0;0;0
5975;0;0;0;0;0
5976;0;0;0;0;0
5977;0;0;0;0;0
5978;0;0;0;0;0
5980;0;0;0;0;0
5981;0;0;0;0;0
5983;0;0;0;0;0
5984;0;0;0;0;0
5985;0;0;0;0;0
5986;0;0;0;0;0
5987;0;0;0;0;0
5988;0;0;0;0;0
5989;0;0;0;0;0
5990;27;232;170;0;429
5991;0;0;0;0;0
5992;162;405;225;0;792
5993;120;779;180;0;1079
5994;40;214;83;0;337
5995;16;46;40;0;102
5997;0;0;0;0;0
5998;0;38;24;0;62
5999;10;70;30;0;110
6001;0;0;0;0;0
6003;0;0;15;0;15
6005;6;97;44;0;147
6006;0;45;44;0;89
6007;104;440;0;0;544
6009;0;0;0;0;0
6010;0;0;0;0;0
6011;0;0;0;0;0
6012;74;44;44;0;162
6013;0;0;0;0;0
6014;0;0;0;0;0
6015;0;0;0;0;0
6017;0;0;0;0;0
6018;60;258;90;0;408
6019;52;38;50;0;140
6020;0;0;0;0;0
6021;0;4;10;0;14
6022;0;0;22;0;22
6023;0;76;10;0;86
6024;0;4;10;0;14
6025;44;0;44;0;88
6026;0;0;0;0;0
6027;176;822;352;0;1350
6028;0;0;0;0;0
6029;44;352;88;0;484
6030;40;88;44;0;172
6031;0;88;22;0;110
6032;0;0;0;0;0
6034;0;0;0;0;0
6035;0;0;0;0;0
6036;44;176;44;0;264
6037;0;0;0;0;0
6038;56;125;45;0;226
6039;32;276;132;0;440
6040;16;44;40;0;100
6041;0;0;0;0;0
6042;0;0;8;0;8
6043;0;70;36;0;106
6044;0;0;23;0;23
6045;8;90;180;0;278
6046;0;66;0;0;66
6048;0;0;6;0;6
6049;39;30;10;0;79
6051;155;484;264;0;903
6052;240;827;308;0;1375
6053;70;108;88;0;266
6054;12;39;73;0;124
6055;0;0;0;0;0
6056;211;543;274;0;1028
6057;0;0;0;0;0
6058;0;0;0;0;0
6059;0;0;0;0;0
6060;96;171;88;0;355
6061;0;0;0;0;0
6062;6;44;35;0;85
6063;12;0;22;0;34
6065;0;0;0;0;0
6066;281;274;253;0;808
6068;0;0;0;0;0
6069;160;191;220;0;571
6070;58;326;102;0;486
6071;126;545;154;0;825
6072;234;673;228;0;1135
6074;0;0;0;0;0
6075;0;0;10;0;10
6076;0;0;10;0;10
6077;0;30;0;0;30
6080;0;0;0;0;0
6082;76;45;45;0;166
6083;0;0;6;0;6
6084;30;696;264;0;990
6085;168;924;308;0;1400
6086;88;632;308;0;1028
6087;154;704;220;0;1078
6088;88;308;132;0;528
6089;142;308;132;0;582
6090;230;548;132;0;910
6091;60;132;44;0;236
6092;120;406;88;0;614
6093;69;88;44;0;201
6094;0;0;0;0;0
6097;0;0;0;0;0
6098;0;0;0;0;0
6101;0;0;0;0;0
6103;0;0;0;0;0
6106;0;0;0;0;0
6107;49;0;44;0;93
6108;14;184;88;0;286
6109;0;0;0;0;0
6111;0;0;0;0;0
6112;89;470;315;0;874
6113;140;863;180;0;1183
6115;11;793;72;0;876
6116;94;567;165;0;826
6117;22;4;89;0;115
6118;237;428;403;0;1068
6119;142;646;286;0;1074
6120;146;632;774;0;1552
6121;18;128;22;0;168
6122;133;530;90;0;753
6123;12;0;82;0;94
6124;61;40;40;0;141
6126;24;86;45;0;155
6127;0;0;10;0;10
6129;10;0;1;0;11
6130;0;0;0;0;0
6132;0;0;0;0;0
6135;60;204;85;0;349
6136;0;0;0;0;0
6137;57;118;91;0;266
6138;0;120;0;0;120
6139;0;5;17;0;22
6140;0;0;15;0;15
6141;0;0;0;0;0
6142;0;20;0;0;20
6143;0;4;0;0;4
6144;0;0;5;0;5
6146;0;0;0;0;0
6147;0;0;5;0;5
6148;0;0;0;0;0
6149;0;44;82;0;126
6150;0;0;0;0;0
6151;0;0;4;0;4
6153;0;0;0;0;0
6154;20;38;0;0;58
6155;0;0;10;0;10
6156;0;0;0;0;0
6157;0;0;33;0;33
6160;0;0;50;0;50
6161;0;0;0;0;0
6163;230;1000;440;0;1670
6164;514;825;201;0;1540
6165;117;260;109;0;486
6166;186;440;88;0;714
6167;82;144;88;0;314
6168;14;0;44;0;58
6170;70;38;164;0;272
6172;0;0;0;0;0
6173;0;44;38;0;82
6174;0;0;0;0;0
6175;0;42;44;0;86
6177;0;0;44;0;44
6178;34;62;44;0;140
6179;0;32;44;0;76
6180;0;0;44;0;44
6181;24;264;112;0;400
6182;0;0;0;0;0
6183;192;96;88;0;376
6184;0;0;0;0;0
6187;0;0;0;0;0
6188;99;460;391;0;950
6189;126;298;155;0;579
6190;90;260;90;0;440
6192;16;12;45;0;73
6194;0;0;0;0;0
6195;0;0;0;0;0
6196;0;0;0;0;0
6197;0;0;0;0;0
6198;42;20;25;0;87
6200;43;311;90;0;444
6203;0;0;0;0;0
6204;32;231;45;0;308
6205;81;163;164;0;408
6206;16;44;15;0;75
6207;30;110;45;0;185
6208;0;24;42;0;66
6210;0;505;675;0;1180
6211;0;0;5;0;5
6213;0;0;0;0;0
6214;0;135;125;0;260
6216;26;102;40;0;168
6217;0;0;0;0;0
6219;0;48;102;0;150
6220;21;111;45;0;177
6221;0;45;0;0;45
6222;0;0;15;0;15
6223;148;661;264;0;1073
6224;416;488;176;0;1080
6225;118;277;132;0;527
6227;174;337;132;0;643
6228;0;0;0;0;0
6229;0;0;0;0;0
6230;105;650;220;0;975
6231;15;35;44;0;94
6232;0;0;0;0;0
6233;0;0;0;0;0
6234;0;0;0;0;0
6235;0;0;0;0;0
6236;0;0;0;0;0
6237;0;20;82;0;102
6238;0;0;0;0;0
6239;0;0;0;0;0
6240;0;0;0;0;0
6242;0;0;0;0;0
6244;0;0;0;0;0
6245;0;0;0;0;0
6246;0;0;0;0;0
6247;0;0;0;0;0
6248;0;0;0;0;0
6249;0;0;0;0;0
6251;8;66;44;0;118
6252;97;989;495;0;1581
6253;400;315;180;0;895
6254;409;246;827;0;1482
6256;0;0;0;0;0
6258;0;0;0;0;0
6259;0;0;0;0;0
6261;0;0;0;0;0
6262;60;14;75;0;149
6263;0;0;10;0;10
6264;0;0;0;0;0
6265;0;0;0;0;0
6267;75;429;225;0;729
6268;55;108;110;0;273
6269;86;682;44;0;812
6270;179;714;264;0;1157
6271;170;572;132;0;874
6272;126;562;88;0;776
6273;191;956;264;0;1411
6276;0;44;0;0;44
6277;0;0;0;0;0
6278;0;0;0;0;0
6279;0;0;6;0;6
6280;0;0;6;0;6
6281;0;0;6;0;6
6282;0;0;6;0;6
6283;0;44;6;0;50
6284;0;0;0;0;0
6285;132;804;176;0;1112
6286;0;0;0;0;0
6289;0;0;6;0;6
6290;0;44;8;0;52
6293;0;0;0;0;0
6294;64;134;45;0;243
6296;0;0;0;0;0
6298;0;0;0;0;0
6299;0;0;0;0;0
6300;176;270;225;0;671
6301;20;396;220;0;636
6302;44;646;352;0;1042
6303;98;220;66;0;384
6304;237;1020;573;0;1830
6305;78;228;88;0;394
6308;64;216;132;0;412
6309;0;0;0;0;0
6311;0;0;0;0;0
6312;0;0;0;0;0
6314;0;0;0;0;0
6315;5;0;0;0;5
6317;0;0;0;0;0
6318;0;0;0;0;0
6319;16;0;0;0;16
6320;0;0;0;0;0
6321;0;0;0;0;0
6322;0;0;0;0;0
6323;9;0;0;0;9
6325;5;0;0;0;5
6326;0;0;0;0;0
6327;5;0;0;0;5
6328;0;0;0;0;0
6329;5;0;0;0;5
6330;5;0;0;0;5
6331;0;0;0;0;0
6332;5;0;0;0;5
6333;5;0;0;0;5
6334;0;0;0;0;0
6335;0;0;0;0;0
6336;370;804;890;0;2064
6337;24;45;135;0;204
6340;0;0;0;0;0
6343;0;0;44;0;44
6344;0;0;45;0;45
6345;0;0;0;0;0
6347;30;68;0;0;98
6348;88;668;228;0;984
6349;212;794;264;0;1270
6350;68;464;168;0;700
6351;160;388;230;0;778
6352;117;488;44;0;649
6353;16;22;0;0;38
6354;0;0;0;0;0
6356;0;0;0;0;0
6357;0;0;0;0;0
6358;0;0;44;0;44
6359;0;0;0;0;0
6360;0;0;0;0;0
6361;0;0;22;0;22
6362;0;0;0;0;0
6363;4;8;0;0;12
6364;0;0;0;0;0
6365;0;0;0;0;0
6366;0;0;0;0;0
6367;0;0;0;0;0
6368;0;0;0;0;0
6370;0;0;0;0;0
6371;12;4;0;0;16
6373;0;44;66;0;110
6374;0;0;0;0;0
6375;0;0;0;0;0
6377;0;0;0;0;0
6378;0;0;0;0;0
6379;5;116;62;0;183
6380;70;283;90;0;443
6381;8;270;315;0;593
6382;0;0;22;0;22
6384;0;0;0;0;0
6385;134;84;176;0;394
6387;0;0;0;0;0
6388;0;0;0;0;0
6389;100;286;240;0;626
6390;0;25;10;0;35
6391;0;30;15;0;45
6392;0;214;45;0;259
6393;16;173;114;0;303
6397;88;484;176;0;748
6398;88;924;624;0;1636
6399;206;880;0;0;1086
6400;0;0;0;0;0
6401;0;0;0;0;0
6402;0;0;0;0;0
6403;0;0;0;0;0
6404;0;0;0;0;0
6406;0;0;0;0;0
6407;0;0;22;0;22
6408;0;0;0;0;0
6409;0;0;0;0;0
6410;0;0;22;0;22
6411;0;0;22;0;22
6412;0;0;0;0;0
6413;0;0;22;0;22
6414;0;0;0;0;0
6415;0;0;22;0;22
6416;0;0;0;0;0
6417;0;0;0;0;0
6418;0;0;0;0;0
6420;0;243;90;0;333
6421;32;355;45;0;432
6423;24;94;68;0;186
6424;78;62;65;0;205
6425;0;0;5;0;5
6426;0;0;0;0;0
6427;38;142;0;0;180
6429;0;0;40;0;40
6432;0;0;82;0;82
6433;0;0;0;0;0
6434;79;132;88;0;299
6435;0;7;0;0;7
6440;0;0;0;0;0
6441;0;20;23;0;43
6442;0;0;0;0;0
6443;0;45;26;0;71
6444;0;0;67;0;67
6445;0;0;0;0;0
6446;0;22;14;0;36
6448;0;0;0;0;0
6449;0;4;44;0;48
6452;154;968;440;0;1562
6454;32;47;88;0;167
6455;30;76;44;0;150
6456;24;38;44;0;106
6457;213;550;334;0;1097
6458;24;20;44;0;88
6459;96;38;122;0;256
6460;69;610;135;0;814
6461;68;144;45;0;257
6462;0;0;0;0;0
6463;0;0;0;0;0
6464;0;0;24;0;24
6465;35;216;332;0;583
6466;0;0;0;0;0
6468;0;0;0;0;0
6469;0;0;0;0;0
6471;6;132;132;0;270
6473;0;0;0;0;0
6474;12;0;90;0;102
6475;0;42;0;0;42
6476;0;0;0;0;0
6477;0;0;22;0;22
6478;14;0;24;0;38
6479;4;38;68;0;110
6480;61;200;12;0;273
6481;10;45;45;0;100
6482;0;4;0;0;4
6483;0;0;0;0;0
6485;0;76;39;0;115
6486;0;0;10;0;10
6487;0;129;111;0;240
6488;10;340;67;0;417
6489;0;106;0;0;106
6490;6;0;20;0;26
6491;0;0;0;0;0
6492;6;20;40;0;66
6494;0;0;0;0;0
6495;62;32;44;0;138
6496;33;45;64;0;142
6497;275;1501;616;0;2392
6499;211;924;308;0;1443
6500;595;1176;704;0;2475
6501;422;1258;705;0;2385
6502;68;346;176;0;590
6504;170;536;132;0;838
6505;0;0;0;0;0
6506;0;0;0;0;0
6507;0;0;0;0;0
6508;0;0;0;0;0
6509;0;0;0;0;0
6510;0;0;0;0;0
6511;0;0;0;0;0
6512;0;0;8;0;8
6513;0;0;0;0;0
6514;0;0;0;0;0
6515;8;0;0;0;8
6516;0;0;0;0;0
6518;0;8;44;0;52
6519;0;0;0;0;0
6521;0;0;0;0;0
6522;0;0;0;0;0
6523;0;0;0;0;0
6524;0;0;0;0;0
6525;4;0;22;0;26
6526;0;0;0;0;0
6527;0;44;0;0;44
6528;72;94;44;0;210
6529;0;0;0;0;0
6530;0;0;8;0;8
6531;0;0;0;0;0
6532;0;0;0;0;0
6533;0;0;0;0;0
6535;0;0;0;0;0
6536;0;0;0;0;0
6537;0;0;0;0;0
6538;0;0;0;0;0
6539;0;0;0;0;0
6540;0;0;0;0;0
6541;0;0;0;0;0
6542;0;115;90;0;205
6544;0;0;0;0;0
6545;0;0;0;0;0
6546;0;0;0;0;0
6547;0;0;10;0;10
6549;0;52;0;0;52
6550;4;44;44;0;92
6552;8;19;62;0;89
6553;0;0;0;0;0
6554;0;0;0;0;0
6555;0;0;28;0;28
6556;0;0;0;0;0
6558;0;0;0;0;0
6560;20;0;40;0;60
6561;0;0;0;0;0
6562;45;188;85;0;318
6564;84;52;164;0;300
6566;63;91;60;0;214
6567;0;0;0;0;0
6568;0;0;0;0;0
6569;20;295;40;0;355
6570;0;0;0;0;0
6571;0;0;0;0;0
6572;0;60;22;0;82
6575;0;50;15;0;65
6576;0;44;10;0;54
6577;56;379;65;0;500
6578;0;0;2;0;2
6580;0;4;0;0;4
6583;0;152;74;0;226
6584;0;575;396;0;971
6585;680;1187;1056;0;2923
6586;339;1202;306;0;1847
6587;505;1220;132;0;1857
6588;276;518;396;0;1190
6589;124;476;264;0;864
6590;62;658;176;0;896
6591;0;0;0;0;0
6593;46;82;44;0;172
6594;0;0;0;0;0
6595;0;0;0;0;0
6597;0;0;0;0;0
6598;0;0;0;0;0
6599;23;54;40;0;117
6600;0;0;0;0;0
6602;0;24;0;0;24
6603;0;0;0;0;0
6604;187;776;176;0;1139
6605;40;0;0;0;40
6606;0;0;0;0;0
6607;0;0;0;0;0
6608;16;6;38;0;60
6610;0;0;0;0;0
6611;0;81;0;0;81
6612;0;38;0;0;38
6613;0;0;0;0;0
6614;0;0;0;0;0
6616;0;24;0;0;24
6617;0;0;0;0;0
6618;0;0;0;0;0
6620;0;0;0;0;0
6621;0;8;0;0;8
6622;0;6;0;0;6
6623;16;38;0;0;54
6624;23;70;44;0;137
6625;0;0;0;0;0
6626;28;0;0;0;28
6627;0;38;0;0;38
6628;16;0;0;0;16
6630;0;0;0;0;0
6631;0;0;0;0;0
6633;12;84;0;0;96
6634;0;0;0;0;0
6635;0;0;0;0;0
6636;0;0;0;0;0
6637;0;0;0;0;0
6638;0;0;0;0;0
6639;13;95;0;0;108
6641;99;576;45;0;720
6642;0;0;0;0;0
6643;51;959;390;0;1400
6644;361;655;455;0;1471
6645;0;0;0;0;0
6647;16;89;90;0;195
6648;0;0;0;0;0
6649;179;311;315;0;805
6650;40;1084;315;0;1439
6651;0;0;0;0;0
6652;39;340;220;0;599
6653;0;0;2;0;2
6654;25;8;40;0;73
6655;0;0;0;0;0
6656;89;45;90;0;224
6657;0;0;0;0;0
6658;0;0;11;0;11
6659;0;0;0;0;0
6660;0;45;0;0;45
6661;0;0;0;0;0
6662;50;0;36;0;86
6664;0;0;0;0;0
6665;0;0;0;0;0
6666;28;60;74;0;162
6667;57;264;0;0;321
6668;0;0;0;0;0
6669;98;537;346;0;981
6670;0;44;39;0;83
6671;10;0;103;0;113
6672;0;0;0;0;0
6673;0;0;7;0;7
6674;30;0;20;0;50
6676;0;0;0;0;0
6678;0;12;45;0;57
6679;0;0;45;0;45
6681;0;39;22;0;61
6682;0;0;0;0;0
6683;0;4;6;0;10
6684;0;0;51;0;51
6686;18;278;0;0;296
6687;0;2;0;0;2
6688;40;80;130;0;250
6689;0;40;0;0;40
6690;36;92;270;0;398
6691;191;830;45;0;1066
6692;0;61;360;0;421
6693;0;0;0;0;0
6695;0;140;205;0;345
6696;0;0;0;0;0
6698;0;0;6;0;6
6699;0;270;0;0;270
6700;0;72;40;0;112
6701;0;0;135;0;135
6702;0;18;62;0;80
6703;0;0;0;0;0
6705;0;90;99;0;189
6706;0;0;0;0;0
6707;0;0;0;0;0
6708;198;554;313;0;1065
6709;226;714;296;0;1236
6710;32;190;172;0;394
6711;32;131;104;0;267
6712;74;276;88;0;438
6714;32;0;188;0;220
6715;0;0;44;0;44
6716;6;0;80;0;86
6717;0;0;0;0;0
6718;24;144;288;0;456
6719;0;0;44;0;44
6720;0;0;0;0;0
6721;0;46;44;0;90
6722;0;0;44;0;44
6723;0;0;0;0;0
6725;34;0;64;0;98
6726;16;40;88;0;144
6728;38;0;40;0;78
6729;0;0;0;0;0
6731;22;46;44;0;112
6732;72;108;148;0;328
6733;0;0;0;0;0
6734;20;0;0;0;20
6735;0;56;90;0;146
6736;10;0;5;0;15
6737;0;165;20;0;185
6738;0;0;22;0;22
6739;0;0;44;0;44
6740;0;0;0;0;0
6741;0;0;14;0;14
6742;0;0;0;0;0
6743;4;8;20;0;32
6745;0;40;0;0;40
6746;0;0;0;0;0
6747;0;30;45;0;75
6748;30;0;15;0;45
6750;0;0;3;0;3
6751;273;408;484;0;1165
6752;263;765;308;0;1336
6753;232;762;308;0;1302
6754;64;663;176;0;903
6755;272;484;396;0;1152
6756;0;0;0;0;0
6757;106;264;264;0;634
6759;211;1038;264;0;1513
6760;0;0;0;0;0
6762;409;1134;132;0;1675
6763;0;0;0;0;0
6764;150;1064;400;0;1614
6765;162;352;220;0;734
6766;458;1084;176;0;1718
6767;163;408;220;0;791
6768;45;44;132;0;221
6769;0;0;0;0;0
6770;216;1220;264;0;1700
6771;0;0;0;0;0
6772;0;176;176;0;352
6773;208;506;374;0;1088
6774;92;362;220;0;674
6777;250;388;308;0;946
6779;0;0;0;0;0
6780;369;772;390;0;1531
6781;162;429;132;0;723
6784;0;0;0;0;0
6785;390;553;264;0;1207
6786;223;714;132;0;1069
6787;44;176;176;0;396
6788;0;0;0;0;0
6790;0;0;0;0;0
6791;130;674;176;0;980
6793;18;181;88;0;287
6794;0;0;0;0;0
6795;0;0;0;0;0
6797;68;132;88;0;288
6798;0;0;0;0;0
6799;0;0;0;0;0
6800;0;0;0;0;0
6803;0;0;0;0;0
6804;0;0;0;0;0
6805;0;0;0;0;0
6807;0;0;44;0;44
6812;0;0;0;0;0
6814;7;0;44;0;51
6815;8;24;0;0;32
6816;0;0;44;0;44
6817;4;0;44;0;48
6818;16;82;0;0;98
6820;0;0;0;0;0
6821;0;0;0;0;0
6822;0;0;0;0;0
6824;0;0;0;0;0
6826;145;180;630;0;955
6827;0;0;0;0;0
6828;0;135;0;0;135
6829;135;519;565;0;1219
6830;278;1109;765;0;2152
6832;147;316;420;0;883
6833;117;292;169;0;578
6834;72;570;135;0;777
6835;118;1036;360;0;1514
6836;0;154;134;0;288
6837;0;0;0;0;0
6841;0;45;89;0;134
6843;74;389;0;0;463
6844;283;768;765;0;1816
6845;0;0;0;0;0
6846;130;667;172;0;969
6848;0;58;45;0;103
6852;42;201;44;0;287
6853;116;344;200;0;660
6854;0;0;0;0;0
6855;0;0;0;0;0
6857;66;44;22;0;132
6859;0;0;0;0;0
6860;0;0;0;0;0
6862;0;0;0;0;0
6865;0;44;30;0;74
6866;0;92;22;0;114
6867;0;0;0;0;0
6868;0;0;0;0;0
6872;0;0;0;0;0
6875;0;0;0;0;0
6876;22;261;88;0;371
6877;0;0;0;0;0
6878;0;0;0;0;0
6879;0;0;0;0;0
6880;0;0;0;0;0
6881;0;0;0;0;0
6882;0;0;0;0;0
6883;0;0;0;0;0
6884;0;0;0;0;0
6885;0;0;0;0;0
6886;122;882;66;0;1070
6888;0;0;0;0;0
6889;0;0;0;0;0
6891;8;118;0;0;126
6892;0;0;0;0;0
6893;0;0;0;0;0
6895;206;1060;270;0;1536
6896;44;189;225;0;458
6897;132;534;286;0;952
6898;220;509;176;0;905
6899;197;808;286;0;1291
6900;0;0;0;0;0
6901;0;88;22;0;110
6902;88;0;22;0;110
6903;49;0;22;0;71
6904;0;0;0;0;0
6905;9;44;44;0;97
6907;0;0;0;0;0
6908;0;0;0;0;0
6909;0;0;0;0;0
6912;0;0;0;0;0
6913;0;0;0;0;0
6914;0;0;0;0;0
6915;0;0;0;0;0
6916;128;615;132;0;875
6917;126;442;90;0;658
6918;108;488;195;0;791
6919;0;0;0;0;0
6920;32;390;45;0;467
6921;0;0;0;0;0
6922;68;270;135;0;473
6924;0;0;0;0;0
6925;68;262;990;0;1320
6929;132;484;264;0;880
6930;361;640;132;0;1133
6931;0;0;0;0;0
6932;156;497;176;0;829
6933;75;170;132;0;377
6934;196;924;176;0;1296
6935;73;440;88;0;601
6936;0;0;0;0;0
6938;132;0;0;0;132
6939;0;0;0;0;0
6941;0;0;0;0;0
6942;4;0;0;0;4
6943;0;0;0;0;0
6944;8;0;44;0;52
6945;0;0;0;0;0
6946;3;0;0;0;3
6947;0;0;0;0;0
6948;0;0;0;0;0
6949;0;0;0;0;0
6950;8;0;0;0;8
6951;0;0;0;0;0
6953;64;88;88;0;240
6955;7;0;44;0;51
6956;11;0;0;0;11
6957;0;0;0;0;0
6958;0;0;0;0;0
6959;0;0;0;0;0
6961;0;0;0;0;0
6962;0;0;0;0;0
6963;0;0;0;0;0
6964;60;404;287;0;751
6965;0;0;20;0;20
6969;0;0;0;0;0
6970;3;185;0;0;188
6972;0;0;0;0;0
6973;0;0;0;0;0
6975;0;0;0;0;0
6978;0;0;0;0;0
6979;0;0;0;0;0
6980;0;0;0;0;0
6981;0;0;30;0;30
6982;0;10;22;0;32
6983;280;1314;350;0;1944
6984;79;432;176;0;687
6986;89;340;88;0;517
6987;0;0;0;0;0
6988;0;0;11;0;11
6989;2;0;11;0;13
6990;0;88;0;0;88
6991;0;54;44;0;98
6992;0;0;11;0;11
6994;0;0;0;0;0
6995;0;0;0;0;0
6996;4;44;44;0;92
7000;0;30;22;0;52
7001;0;0;0;0;0
7003;0;208;108;0;316
7004;212;360;543;0;1115
7006;120;841;315;0;1276
7008;0;0;0;0;0
7009;65;54;0;0;119
7011;15;112;39;0;166
7012;0;0;0;0;0
7013;0;10;0;0;10
7014;0;0;0;0;0
7015;52;386;132;0;570
7016;114;630;214;0;958
7018;0;0;0;0;0
7020;30;84;44;0;158
7021;0;0;0;0;0
7023;65;314;88;0;467
7024;40;38;44;0;122
7025;40;38;44;0;122
7026;40;120;0;0;160
7027;0;0;0;0;0
7029;0;0;0;0;0
7030;40;44;0;0;84
7031;102;838;556;0;1496
7032;11;301;176;0;488
7034;0;0;0;0;0
7037;0;38;0;0;38
7038;0;0;0;0;0
7039;0;0;0;0;0
7040;0;0;0;0;0
7041;0;0;0;0;0
7042;0;0;0;0;0
7044;124;727;240;0;1091
7045;0;0;0;0;0
7047;0;0;0;0;0
7049;280;612;404;0;1296
7050;324;904;261;0;1489
7051;0;38;0;0;38
7052;0;0;0;0;0
7054;0;0;0;0;0
7055;0;0;0;0;0
7056;0;0;0;0;0
7057;0;32;0;0;32
7058;0;38;6;0;44
7059;198;726;360;0;1284
7060;0;0;0;0;0
7061;108;398;89;0;595
7062;132;433;135;0;700
7063;176;504;135;0;815
7064;110;158;75;0;343
7065;0;0;0;0;0
7066;0;0;0;0;0
7068;0;0;0;0;0
7069;0;0;0;0;0
7071;44;42;45;0;131
7072;23;0;0;0;23
7073;0;0;0;0;0
7074;0;32;0;0;32
7075;0;0;0;0;0
7076;0;0;0;0;0
7077;0;0;0;0;0
7078;18;38;0;0;56
7079;0;0;0;0;0
7080;0;0;0;0;0
7081;0;0;0;0;0
7083;98;102;45;0;245
7085;90;360;89;0;539
7086;49;66;0;0;115
7087;0;0;0;0;0
7088;0;0;0;0;0
7089;0;0;0;0;0
7090;0;0;0;0;0
7091;0;0;0;0;0
7092;57;70;29;0;156
7093;0;0;0;0;0
7094;0;0;0;0;0
7095;0;0;0;0;0
7096;0;0;0;0;0
7097;0;0;0;0;0
7099;0;0;0;0;0
7100;158;76;35;0;269
7101;0;0;0;0;0
7102;71;785;135;0;991
7104;0;0;0;0;0
7105;0;0;0;0;0
7106;0;0;0;0;0
7108;90;224;128;0;442
7109;0;0;0;0;0
7110;0;0;0;0;0
7111;16;33;45;0;94
7112;8;106;24;0;138
7113;0;64;20;0;84
7114;88;318;135;0;541
7115;68;205;58;0;331
7116;0;0;10;0;10
7118;0;90;0;0;90
7119;0;0;0;0;0
7121;0;0;0;0;0
7122;82;240;135;0;457
7123;0;0;0;0;0
7124;0;42;0;0;42
7125;56;92;352;0;500
7127;0;0;0;0;0
7128;240;790;552;0;1582
7129;226;907;528;0;1661
7130;514;132;346;0;992
7131;248;380;352;0;980
7132;205;563;132;0;900
7133;139;212;88;0;439
7135;74;156;132;0;362
7136;14;88;132;0;234
7137;21;90;162;0;273
7138;17;293;152;0;462
7139;0;0;0;0;0
7140;113;164;176;0;453
7141;0;0;15;0;15
7142;16;82;22;0;120
7143;0;0;0;0;0
7145;0;0;0;0;0
7147;17;38;44;0;99
7149;0;0;0;0;0
7153;0;0;0;0;0
7154;0;0;0;0;0
7156;0;0;0;0;0
7157;52;25;74;0;151
7158;0;0;15;0;15
7159;0;0;0;0;0
7160;0;0;15;0;15
7161;0;0;0;0;0
7162;0;0;0;0;0
7164;0;0;0;0;0
7166;98;88;88;0;274
7167;0;0;0;0;0
7168;0;44;208;0;252
7169;0;0;0;0;0
7170;17;46;44;0;107
7171;0;0;0;0;0
7172;0;0;0;0;0
7173;0;0;15;0;15
7174;0;44;44;0;88
7176;0;0;0;0;0
7178;0;0;15;0;15
7180;225;185;241;0;651
7181;70;433;347;0;850
7183;70;415;170;0;655
7184;0;0;36;0;36
7185;0;45;0;0;45
7186;0;0;0;0;0
7187;0;15;0;0;15
7188;0;0;5;0;5
7190;0;0;45;0;45
7192;0;68;22;0;90
7193;0;38;10;0;48
7195;0;38;39;0;77
7197;0;0;0;0;0
7198;0;0;0;0;0
7199;0;0;0;0;0
7200;132;634;494;0;1260
7202;138;1053;406;0;1597
7203;88;821;352;0;1261
7204;21;352;174;0;547
7205;8;266;176;0;450
7206;40;448;219;0;707
7207;0;0;0;0;0
7208;0;0;0;0;0
7209;0;0;0;0;0
7210;0;0;0;0;0
7211;0;0;0;0;0
7212;0;40;0;0;40
7213;0;0;0;0;0
7214;0;37;0;0;37
7216;0;0;0;0;0
7217;0;88;25;0;113
7218;0;0;0;0;0
7219;0;0;0;0;0
7220;0;0;0;0;0
7221;0;0;0;0;0
7223;0;0;0;0;0
7224;0;0;0;0;0
7225;0;0;20;0;20
7227;0;0;0;0;0
7228;0;0;0;0;0
7230;0;0;0;0;0
7231;116;578;112;0;806
7233;0;0;0;0;0
7234;0;466;45;0;511
7235;0;0;0;0;0
7236;216;715;396;0;1327
7237;306;1258;704;0;2268
7238;125;584;214;0;923
7239;0;30;30;0;60
7240;243;634;110;0;987
7241;0;0;0;0;0
7242;122;192;82;0;396
7243;60;34;214;0;308
7244;106;147;202;0;455
7245;0;0;0;0;0
7247;0;0;0;0;0
7248;0;0;0;0;0
7249;0;4;33;0;37
7250;5;170;44;0;219
7251;0;0;0;0;0
7252;22;170;88;0;280
7253;0;0;0;0;0
7254;0;0;0;0;0
7255;0;0;0;0;0
7256;0;0;0;0;0
7257;0;0;22;0;22
7258;0;0;0;0;0
7259;0;0;0;0;0
7260;1;122;44;0;167
7261;0;0;44;0;44
7262;0;0;0;0;0
7264;0;0;0;0;0
7265;0;0;0;0;0
7266;0;88;44;0;132
7267;0;0;0;0;0
7268;0;0;33;0;33
7269;0;0;0;0;0
7270;0;0;0;0;0
7272;0;0;0;0;0
7273;0;88;88;0;176
7274;0;0;0;0;0
7275;0;0;0;0;0
7276;198;902;405;0;1505
7279;0;5;0;0;5
7282;0;0;40;0;40
7283;0;0;0;0;0
7284;0;20;74;0;94
7285;44;40;97;0;181
7286;0;0;0;0;0
7287;0;0;0;0;0
7288;0;2;0;0;2
7289;0;45;0;0;45
7290;0;44;44;0;88
7291;0;0;0;0;0
7292;0;6;0;0;6
7295;0;32;0;0;32
7296;0;84;0;0;84
7297;0;0;0;0;0
7298;0;0;0;0;0
7299;382;602;1110;0;2094
7300;0;0;0;0;0
7301;66;0;220;0;286
7302;6;88;46;0;140
7303;91;308;176;0;575
7304;0;0;44;0;44
7305;6;44;44;0;94
7306;0;55;44;0;99
7307;0;46;44;0;90
7308;3;0;44;0;47
7309;23;44;66;0;133
7310;0;0;0;0;0
7311;0;0;0;0;0
7312;44;193;50;0;287
7314;0;40;0;0;40
7315;0;56;75;0;131
7316;0;0;10;0;10
7317;0;0;0;0;0
7318;20;0;0;0;20
7319;0;0;0;0;0
7321;0;0;38;0;38
7322;0;0;0;0;0
7323;0;0;0;0;0
7325;314;852;506;0;1672
7326;211;616;352;0;1179
7328;308;338;352;0;998
7329;220;616;396;0;1232
7331;220;844;528;0;1592
7332;133;392;132;0;657
7333;245;270;132;0;647
7334;169;604;264;0;1037
7335;107;466;88;0;661
7336;148;274;132;0;554
7337;64;708;176;0;948
7338;338;280;264;0;882
7339;176;720;176;0;1072
7340;157;558;132;0;847
7341;194;379;264;0;837
7342;0;0;0;0;0
7343;177;588;264;0;1029
7345;153;74;88;0;315
7346;113;492;132;0;737
7347;62;264;88;0;414
7348;276;276;132;0;684
7349;254;298;220;0;772
7350;0;0;0;0;0
7352;266;701;132;0;1099
7353;260;1066;296;0;1622
7354;80;220;88;0;388
7355;0;70;44;0;114
7356;0;0;44;0;44
7357;0;0;88;0;88
7359;0;0;44;0;44
7360;0;0;0;0;0
7362;0;0;0;0;0
7363;0;0;0;0;0
7364;0;0;0;0;0
7365;0;0;0;0;0
7366;0;0;44;0;44
7367;0;0;0;0;0
7368;0;44;44;0;88
7369;152;220;176;0;548
7370;0;0;0;0;0
7371;0;15;44;0;59
7372;35;44;44;0;123
7373;0;0;0;0;0
7374;0;0;0;0;0
7376;0;0;0;0;0
7377;198;88;88;0;374
7378;0;0;0;0;0
7379;0;0;0;0;0
7380;0;6;22;0;28
7381;0;0;22;0;22
7382;0;44;44;0;88
7383;0;0;0;0;0
7384;16;0;44;0;60
7385;48;107;293;0;448
7386;0;45;45;0;90
7388;131;1016;495;0;1642
7390;16;0;40;0;56
7391;58;90;90;0;238
7393;0;0;0;0;0
7395;0;0;0;0;0
7396;77;121;137;0;335
7397;0;369;129;0;498
7398;0;0;0;0;0
7399;0;0;0;0;0
7400;0;0;0;0;0
7401;159;570;666;0;1395
7402;0;0;0;0;0
7403;205;510;179;0;894
7404;54;208;175;0;437
7405;35;509;90;0;634
7406;44;44;0;0;88
7407;0;44;176;0;220
7412;325;807;337;0;1469
7414;27;0;0;0;27
7415;357;862;675;0;1894
7416;300;907;405;0;1612
7417;0;0;0;0;0
7418;99;448;132;0;679
7419;139;162;152;0;453
7420;0;0;0;0;0
7421;0;0;0;0;0
7422;0;0;0;0;0
7423;0;0;0;0;0
7424;0;18;22;0;40
7426;0;0;0;0;0
7427;0;50;44;0;94
7428;0;0;0;0;0
7429;0;0;0;0;0
7430;0;0;0;0;0
7431;0;38;22;0;60
7432;0;82;66;0;148
7433;30;68;22;0;120
7434;80;595;162;0;837
7435;0;0;0;0;0
7436;0;0;0;0;0
7437;0;0;0;0;0
7438;0;25;0;0;25
7440;0;45;45;0;90
7441;94;323;360;0;777
7443;126;147;45;0;318
7446;24;135;45;0;204
7447;0;0;0;0;0
7448;264;1010;220;0;1494
7449;64;172;44;0;280
7450;88;226;88;0;402
7452;22;48;44;0;114
7453;0;48;44;0;92
7454;0;0;0;0;0
7455;0;0;0;0;0
7457;0;0;0;0;0
7458;0;12;44;0;56
7459;206;435;176;0;817
7460;75;192;88;0;355
7461;0;0;0;0;0
7462;0;0;0;0;0
7463;0;40;40;0;80
7464;0;52;44;0;96
7465;0;4;22;0;26
7466;0;0;0;0;0
7467;0;0;0;0;0
7468;0;0;0;0;0
7469;0;44;66;0;110
7470;353;875;300;0;1528
7471;0;0;0;0;0
7476;130;288;88;0;506
7477;200;117;154;0;471
7478;148;224;88;0;460
7479;0;30;44;0;74
7480;0;0;0;0;0
7481;0;0;0;0;0
7482;0;0;0;0;0
7484;0;0;0;0;0
7485;0;0;0;0;0
7486;0;0;0;0;0
7488;0;0;0;0;0
7489;0;0;0;0;0
7491;0;0;0;0;0
7492;0;0;0;0;0
7493;0;0;0;0;0
7494;0;0;0;0;0
7495;0;0;0;0;0
7496;154;166;44;0;364
7497;0;30;0;0;30
7498;0;0;44;0;44
7499;0;6;0;0;6
7500;0;0;0;0;0
7501;0;0;0;0;0
7502;0;0;30;0;30
7503;0;0;0;0;0
7505;88;572;264;0;924
7507;118;420;88;0;626
7508;148;490;132;0;770
7509;88;44;66;0;198
7510;66;188;44;0;298
7511;0;44;0;0;44
7512;0;0;0;0;0
7513;0;0;0;0;0
7514;0;0;0;0;0
7515;0;0;0;0;0
7516;0;0;0;0;0
7517;0;0;0;0;0
7518;0;0;0;0;0
7519;0;0;0;0;0
7520;0;0;0;0;0
7521;0;0;0;0;0
7522;0;0;0;0;0
7524;0;0;0;0;0
7525;0;0;0;0;0
7526;0;0;0;0;0
7527;0;0;0;0;0
7528;0;0;0;0;0
7529;0;0;0;0;0
7530;0;0;0;0;0
7531;102;174;44;0;320
7532;0;0;0;0;0
7533;0;0;0;0;0
7534;0;0;0;0;0
7535;0;96;88;0;184
7536;153;908;540;0;1601
7538;0;39;0;0;39
7539;0;0;0;0;0
7541;245;484;176;0;905
7542;220;198;132;0;550
7543;233;396;242;0;871
7544;240;518;220;0;978
7545;0;0;0;0;0
7546;0;0;0;0;0
7547;0;0;0;0;0
7548;0;0;0;0;0
7549;0;0;0;0;0
7550;0;0;0;0;0
7551;0;0;0;0;0
7552;0;0;0;0;0
7553;0;0;0;0;0
7555;0;0;0;0;0
7556;0;0;0;0;0
7557;0;0;0;0;0
7558;0;0;0;0;0
7559;0;0;0;0;0
7560;0;0;0;0;0
7561;0;0;0;0;0
7562;0;0;0;0;0
7563;0;0;0;0;0
7564;0;0;0;0;0
7565;0;0;0;0;0
7566;0;0;0;0;0
7567;0;0;0;0;0
7569;0;0;0;0;0
7570;0;0;0;0;0
7572;0;906;393;0;1299
7573;0;0;0;0;0
7574;0;0;0;0;0
7575;0;0;0;0;0
7576;0;0;0;0;0
7578;360;825;1158;0;2343
7579;0;0;0;0;0
7580;0;19;0;0;19
7581;0;0;0;0;0
7582;0;0;0;0;0
7583;102;244;88;0;434
7584;0;0;0;0;0
7586;0;44;0;0;44
7587;0;0;44;0;44
7588;0;38;44;0;82
7589;0;0;0;0;0
7590;0;28;44;0;72
7591;0;0;0;0;0
7592;0;44;44;0;88
7593;308;640;44;0;992
7594;0;0;0;0;0
7595;0;0;0;0;0
7596;0;0;0;0;0
7597;0;0;0;0;0
7598;0;0;0;0;0
7600;0;66;20;0;86
7601;0;89;90;0;179
7602;0;0;0;0;0
7603;0;0;0;0;0
7605;0;86;0;0;86
7606;0;80;0;0;80
7607;0;40;45;0;85
7608;0;0;0;0;0
7609;0;0;30;0;30
7610;0;45;45;0;90
7611;0;0;0;0;0
7612;0;35;37;0;72
7613;0;98;88;0;186
7614;145;338;495;0;978
7615;0;0;0;0;0
7616;0;11;0;0;11
7617;0;0;40;0;40
7619;0;45;0;0;45
7620;0;40;0;0;40
7622;0;270;0;0;270
7623;0;0;0;0;0
7624;0;44;30;0;74
7625;247;813;308;0;1368
7626;182;836;396;0;1414
7627;218;592;352;0;1162
7628;252;1188;220;0;1660
7629;44;616;308;0;968
7630;211;876;308;0;1395
7631;205;692;220;0;1117
7632;223;762;176;0;1161
7633;176;920;308;0;1404
7634;410;716;264;0;1390
7636;142;677;220;0;1039
7637;194;670;220;0;1084
7638;315;666;214;0;1195
7639;503;964;352;0;1819
7640;0;0;0;0;0
7641;204;548;176;0;928
7642;100;245;132;0;477
7643;182;560;176;0;918
7644;228;782;132;0;1142
7645;176;836;220;0;1232
7646;394;422;128;0;944
7647;401;803;396;0;1600
7648;341;308;132;0;781
7650;209;237;132;0;578
7651;322;830;396;0;1548
7654;107;250;252;0;609
7655;16;168;132;0;316
7656;136;306;44;0;486
7657;0;0;0;0;0
7658;80;128;88;0;296
7659;202;781;264;0;1247
7661;0;0;0;0;0
7662;0;0;10;0;10
7663;0;6;88;0;94
7664;206;513;220;0;939
7665;277;478;220;0;975
7667;65;44;132;0;241
7668;24;74;22;0;120
7669;17;0;88;0;105
7670;38;0;44;0;82
7671;156;268;132;0;556
7672;35;279;76;0;390
7673;0;0;44;0;44
7675;30;74;74;0;178
7676;0;0;44;0;44
7677;8;0;15;0;23
7678;0;0;0;0;0
7679;107;630;0;0;737
7680;0;0;0;0;0
7681;0;0;30;0;30
7682;117;278;132;0;527
7684;30;36;88;0;154
7685;108;478;44;0;630
7686;0;38;80;0;118
7688;0;0;0;0;0
7689;0;20;20;0;40
7690;0;0;0;0;0
7691;22;38;80;0;140
7692;0;0;0;0;0
7693;0;0;44;0;44
7694;0;10;44;0;54
7695;0;0;22;0;22
7696;208;571;176;0;955
7698;6;0;32;0;38
7699;237;2040;1485;0;3762
7700;0;0;0;0;0
7701;254;716;685;0;1655
7704;183;448;300;0;931
7705;304;476;311;0;1091
7706;166;843;495;0;1504
7707;544;562;610;0;1716
7708;0;0;0;0;0
7709;98;866;425;0;1389
7710;0;22;44;0;66
7711;0;0;0;0;0
7712;0;215;0;0;215
7714;94;0;225;0;319
7715;0;0;15;0;15
7717;175;315;450;0;940
7718;0;0;0;0;0
7719;60;300;173;0;533
7720;176;528;264;0;968
7722;216;760;220;0;1196
7723;262;908;264;0;1434
7724;170;580;264;0;1014
7725;62;164;44;0;270
7726;0;0;44;0;44
7727;0;0;0;0;0
7728;0;0;0;0;0
7729;0;0;0;0;0
7730;0;0;0;0;0
7731;0;0;0;0;0
7732;0;0;0;0;0
7734;0;0;0;0;0
7735;0;0;0;0;0
7737;0;0;0;0;0
7738;0;0;0;0;0
7739;0;0;0;0;0
7740;77;158;90;0;325
7741;0;88;88;0;176
7742;0;0;0;0;0
7743;61;833;630;0;1524
7744;426;977;404;0;1807
7745;0;0;0;0;0
7748;0;0;0;0;0
7749;0;0;0;0;0
7752;0;0;44;0;44
7753;172;587;132;0;891
7754;0;44;0;0;44
7755;0;85;0;0;85
7756;22;156;0;0;178
7757;0;0;0;0;0
7758;0;49;0;0;49
7759;0;0;0;0;0
7760;174;491;132;0;797
7761;0;40;0;0;40
7762;0;0;0;0;0
7763;0;186;132;0;318
7765;0;0;0;0;0
7766;0;0;0;0;0
7767;0;0;0;0;0
7768;0;0;0;0;0
7769;0;0;0;0;0
7770;0;0;0;0;0
7771;0;0;0;0;0
7772;176;1001;264;0;1441
7773;196;744;265;0;1205
7774;157;1092;265;0;1514
7775;139;603;176;0;918
7776;38;216;132;0;386
7777;80;284;132;0;496
7779;0;0;40;0;40
7782;0;36;0;0;36
7783;54;300;72;0;426
7784;0;0;0;0;0
7785;44;220;132;0;396
7786;0;44;0;0;44
7787;0;0;0;0;0
7788;43;176;88;0;307
7789;18;228;0;0;246
7790;0;0;0;0;0
7791;0;145;44;0;189
7792;0;0;0;0;0
7793;29;88;44;0;161
7794;0;0;0;0;0
7796;0;0;0;0;0
7797;0;38;0;0;38
7798;0;40;44;0;84
7799;0;38;0;0;38
7801;40;234;44;0;318
7802;113;583;176;0;872
7803;0;0;0;0;0
7804;0;0;30;0;30
7805;0;38;0;0;38
7806;0;0;38;0;38
7807;0;12;0;0;12
7808;0;74;0;0;74
7809;0;0;38;0;38
7810;0;0;60;0;60
7811;0;0;0;0;0
7812;0;44;0;0;44
7813;0;0;0;0;0
7815;20;14;44;0;78
7816;0;0;0;0;0
7817;0;0;0;0;0
7818;151;220;82;0;453
7819;0;0;44;0;44
7820;0;88;0;0;88
7821;0;44;0;0;44
7822;0;0;44;0;44
7823;0;0;30;0;30
7824;0;44;0;0;44
7825;93;833;88;0;1014
7826;778;781;405;0;1964
7829;0;0;0;0;0
7830;168;284;176;0;628
7832;110;608;132;0;850
7833;54;708;88;0;850
7834;132;666;88;0;886
7835;0;0;0;0;0
7836;198;460;132;0;790
7837;0;0;0;0;0
7838;0;0;0;0;0
7839;0;0;0;0;0
7840;0;0;0;0;0
7841;0;0;0;0;0
7842;0;0;0;0;0
7844;0;0;0;0;0
7846;0;0;0;0;0
7847;0;0;0;0;0
7848;0;0;0;0;0
7849;0;0;0;0;0
7850;44;176;0;0;220
7851;0;0;0;0;0
7852;6;0;0;0;6
7853;0;0;0;0;0
7854;0;264;44;0;308
7855;0;0;0;0;0
7856;17;8;0;0;25
7857;0;0;0;0;0
7858;6;52;44;0;102
7860;6;0;0;0;6
7861;19;44;0;0;63
7863;0;0;0;0;0
7864;6;6;0;0;12
7865;0;0;0;0;0
7866;0;528;88;0;616
7867;0;0;0;0;0
7868;6;0;0;0;6
7869;0;0;0;0;0
7870;0;0;0;0;0
7871;0;0;0;0;0
7872;128;594;396;0;1118
7874;60;346;44;0;450
7875;0;0;0;0;0
7877;0;0;0;0;0
7878;17;0;0;0;17
7879;2;0;0;0;2
7880;0;0;0;0;0
7881;28;0;0;0;28
7882;2;0;0;0;2
7883;0;0;0;0;0
7884;0;0;0;0;0
7885;0;0;0;0;0
7886;0;0;0;0;0
7887;2;0;0;0;2
7888;0;0;0;0;0
7889;0;0;0;0;0
7890;0;0;0;0;0
7891;2;0;0;0;2
7892;0;0;0;0;0
7894;17;0;0;0;17
7895;0;0;0;0;0
7896;83;44;88;0;215
7897;50;11;88;0;149
7898;45;137;88;0;270
7900;0;0;0;0;0
7901;2;44;132;0;178
7902;0;0;0;0;0
7903;2;0;0;0;2
7904;2;0;0;0;2
7905;52;10;88;0;150
7906;0;0;0;0;0
7907;266;1206;270;0;1742
7908;0;0;0;0;0
7910;0;0;0;0;0
7911;0;0;58;0;58
7913;0;0;0;0;0
7914;0;0;0;0;0
7915;20;45;0;0;65
7916;0;0;0;0;0
7917;0;0;0;0;0
7918;0;7;0;0;7
7919;0;40;0;0;40
7920;0;0;0;0;0
7921;0;0;0;0;0
7922;45;294;135;0;474
7923;0;0;0;0;0
7924;95;399;220;0;714
7925;0;0;0;0;0
7927;0;0;0;0;0
7929;30;287;88;0;405
7930;0;0;0;0;0
7931;0;0;0;0;0
7932;0;0;0;0;0
7933;0;44;44;0;88
7936;0;0;44;0;44
7937;0;0;0;0;0
7938;0;0;0;0;0
7939;0;0;0;0;0
7940;19;132;44;0;195
7941;225;924;220;0;1369
7942;177;1129;640;0;1946
7944;0;0;0;0;0
7945;0;0;0;0;0
7946;44;4;0;0;48
7947;0;45;0;0;45
7948;0;225;0;0;225
7949;0;45;45;0;90
7950;0;45;0;0;45
7952;0;90;45;0;135
7953;0;44;0;0;44
7954;25;44;77;0;146
7956;131;668;220;0;1019
7958;176;1138;352;0;1666
7959;460;1045;308;0;1813
7961;107;338;88;0;533
7962;44;302;0;0;346
7963;0;0;0;0;0
7964;0;0;0;0;0
7965;0;0;0;0;0
7966;4;0;0;0;4
7967;101;246;88;0;435
7968;5;48;44;0;97
7970;263;395;135;0;793
7971;0;0;0;0;0
7972;0;0;0;0;0
7973;86;924;220;0;1230
7975;122;471;176;0;769
7976;107;509;44;0;660
7977;100;534;176;0;810
7978;0;0;22;0;22
7980;0;0;0;0;0
7982;20;88;44;0;152
7983;0;0;0;0;0
7984;0;0;0;0;0
7985;0;0;0;0;0
7987;12;22;0;0;34
7989;113;324;277;0;714
7990;0;0;12;0;12
7992;0;0;0;0;0
7993;0;0;0;0;0
7994;0;45;0;0;45
7996;0;38;0;0;38
7998;0;132;44;0;176
8000;128;357;123;0;608
8001;256;1566;836;0;2658
8002;288;1001;572;0;1861
8003;185;1318;484;0;1987
8004;132;1020;352;0;1504
8005;246;1337;264;0;1847
8006;56;636;0;0;692
8007;0;0;0;0;0
8009;0;0;0;0;0
8010;0;0;0;0;0
8012;41;426;88;0;555
8013;105;283;88;0;476
8014;0;0;0;0;0
8015;0;0;0;0;0
8016;0;0;0;0;0
8017;0;0;0;0;0
8018;0;0;0;0;0
8019;25;271;0;0;296
8020;4;0;0;0;4
8021;0;0;0;0;0
8022;21;0;44;0;65
8023;0;0;0;0;0
8024;0;0;0;0;0
8026;0;0;0;0;0
8027;38;201;44;0;283
8028;0;0;0;0;0
8029;0;0;0;0;0
8030;0;0;0;0;0
8031;0;0;0;0;0
8032;4;0;0;0;4
8033;0;0;0;0;0
8034;0;0;0;0;0
8035;0;0;0;0;0
8036;32;0;88;0;120
8037;0;0;44;0;44
8038;0;0;0;0;0
8040;0;0;0;0;0
8041;276;596;44;0;916
8043;0;0;0;0;0
8044;250;704;264;0;1218
8046;104;662;88;0;854
8047;141;652;396;0;1189
8048;141;340;308;0;789
8049;173;301;88;0;562
8050;137;384;176;0;697
8051;138;82;164;0;384
8052;0;0;0;0;0
8053;100;206;88;0;394
8054;150;220;88;0;458
8055;0;0;0;0;0
8057;0;0;0;0;0
8058;0;0;0;0;0
8059;0;0;0;0;0
8060;0;0;0;0;0
8061;0;0;0;0;0
8062;0;0;0;0;0
8063;0;0;0;0;0
8064;0;0;0;0;0
8065;0;0;0;0;0
8066;0;0;0;0;0
8067;0;0;0;0;0
8068;0;0;0;0;0
8069;0;0;0;0;0
8070;0;0;0;0;0
8071;0;0;0;0;0
8072;0;0;0;0;0
8074;0;0;0;0;0
8075;0;0;0;0;0
8076;0;0;0;0;0
8077;0;0;0;0;0
8078;0;0;0;0;0
8079;0;0;0;0;0
8080;0;0;0;0;0
8081;0;0;0;0;0
8082;0;0;0;0;0
8083;0;0;0;0;0
8084;0;0;0;0;0
8085;85;170;132;0;387
8086;0;0;0;0;0
8088;0;0;0;0;0
8089;0;0;0;0;0
8091;0;0;0;0;0
8092;36;76;44;0;156
8093;0;0;0;0;0
8094;0;0;0;0;0
8095;0;0;0;0;0
8096;0;0;22;0;22
8097;0;0;0;0;0
8098;0;0;0;0;0
8099;0;0;38;0;38
8100;26;126;126;0;278
8102;0;0;0;0;0
8103;36;120;88;0;244
8104;9;0;10;0;19
8105;176;519;352;0;1047
8107;176;366;162;0;704
8108;790;1260;734;0;2784
8109;121;1375;665;0;2161
8110;0;0;0;0;0
8111;72;288;264;0;624
8112;27;84;44;0;155
8113;27;289;264;0;580
8114;79;252;132;0;463
8115;0;1;0;0;1
8116;0;1;0;0;1
8117;137;247;132;0;516
8118;0;0;0;0;0
8119;0;0;0;0;0
8120;0;0;0;0;0
8121;0;1;0;0;1
8122;0;1;0;0;1
8124;0;1;0;0;1
8125;0;0;0;0;0
8126;0;155;44;0;199
8127;0;0;0;0;0
8128;0;0;0;0;0
8129;0;0;0;0;0
8130;0;0;10;0;10
8131;0;1;0;0;1
8132;0;0;0;0;0
8133;0;23;0;0;23
8134;0;1;0;0;1
8135;0;45;22;0;67
8136;0;1;0;0;1
8138;0;0;0;0;0
8139;0;0;0;0;0
8141;0;0;0;0;0
8142;0;2;78;0;80
8143;0;1;0;0;1
8144;9;0;40;0;49
8145;0;0;10;0;10
8146;0;0;15;0;15
8147;114;519;212;0;845
8148;0;0;0;0;0
8149;0;0;10;0;10
8150;0;0;20;0;20
8151;0;0;0;0;0
8153;0;0;0;0;0
8155;0;0;10;0;10
8156;0;0;0;0;0
8157;0;0;15;0;15
8158;8;0;32;0;40
8159;27;40;40;0;107
8160;9;20;10;0;39
8161;286;988;506;0;1780
8162;381;1044;575;0;2000
8163;0;0;0;0;0
8164;0;0;0;0;0
8165;19;35;44;0;98
8166;0;0;0;0;0
8167;0;0;0;0;0
8169;70;0;60;0;130
8170;65;36;44;0;145
8172;0;0;0;0;0
8173;12;0;0;0;12
8174;296;1925;1313;0;3534
8175;16;6;10;0;32
8176;43;80;51;0;174
8177;36;40;40;0;116
8178;0;0;0;0;0
8179;0;40;10;0;50
8180;52;120;20;0;192
8181;24;120;0;0;144
8182;17;0;20;0;37
8183;22;6;51;0;79
8184;0;40;64;0;104
8186;30;160;40;0;230
8187;0;0;0;0;0
8188;22;124;20;0;166
8189;119;561;200;0;880
8190;16;33;0;0;49
8191;30;282;50;0;362
8193;0;0;10;0;10
8194;291;520;560;0;1371
8195;45;200;168;0;413
8196;0;0;0;0;0
8197;0;0;44;0;44
8198;0;0;44;0;44
8200;0;0;40;0;40
8201;27;0;44;0;71
8202;31;0;40;0;71
8203;29;0;44;0;73
8205;27;38;80;0;145
8206;553;1988;552;0;3093
8207;15;74;66;0;155
8208;10;113;110;0;233
8209;0;0;0;0;0
8210;34;68;0;0;102
8211;118;288;0;0;406
8212;0;0;0;0;0
8213;16;57;0;0;73
8214;0;5;0;0;5
8215;0;0;0;0;0
8216;44;0;15;0;59
8217;14;49;22;0;85
8219;0;0;22;0;22
8220;13;172;88;0;273
8222;0;0;0;0;0
8223;0;5;30;0;35
8224;3;0;22;0;25
8225;0;38;0;0;38
8226;0;5;9;0;14
8227;0;30;44;0;74
8228;0;40;22;0;62
8229;0;0;0;0;0
8230;99;118;44;0;261
8231;12;70;44;0;126
8232;0;0;0;0;0
8233;0;0;0;0;0
8234;0;5;12;0;17
8236;118;893;330;0;1341
8237;0;0;63;0;63
8238;0;0;22;0;22
8239;0;4;22;0;26
8240;0;0;0;0;0
8241;69;220;179;0;468
8242;0;0;0;0;0
8243;54;44;22;0;120
8244;0;4;22;0;26
8245;0;0;0;0;0
8246;0;0;15;0;15
8247;0;162;88;0;250
8248;0;0;0;0;0
8251;0;0;19;0;19
8253;0;0;0;0;0
8254;0;0;22;0;22
8255;132;634;441;0;1207
8256;132;1643;792;0;2567
8257;4;4;15;0;23
8258;48;0;10;0;58
8259;0;0;0;0;0
8260;6;0;20;0;26
8261;19;144;0;0;163
8262;0;0;0;0;0
8263;8;108;30;0;146
8264;78;330;104;0;512
8265;0;0;0;0;0
8267;2;9;20;0;31
8268;7;50;163;0;220
8269;11;42;0;0;53
8270;0;0;0;0;0
8271;0;0;0;0;0
8272;13;4;67;0;84
8273;9;32;0;0;41
8274;8;46;15;0;69
8275;51;0;42;0;93
8276;0;0;0;0;0
8277;0;0;0;0;0
8278;15;41;0;0;56
8279;0;0;0;0;0
8280;0;0;0;0;0
8281;7;0;30;0;37
8282;0;0;0;0;0
8284;55;190;44;0;289
8285;2;38;0;0;40
8286;5;76;24;0;105
8287;0;62;15;0;77
8288;50;148;124;0;322
8289;170;470;54;0;694
8290;22;40;176;0;238
8292;0;0;0;0;0
8293;0;0;0;0;0
8294;0;0;0;0;0
8295;0;30;0;0;30
8296;0;88;45;0;133
8298;0;44;0;0;44
8299;0;0;0;0;0
8300;0;0;0;0;0
8301;28;178;110;0;316
8303;0;0;22;0;22
8304;0;0;0;0;0
8305;0;0;0;0;0
8306;30;79;88;0;197
8307;0;30;22;0;52
8308;0;30;22;0;52
8309;90;576;310;0;976
8310;0;749;44;0;793
8311;53;176;132;0;361
8312;48;34;30;0;112
8313;52;216;104;0;372
8314;0;88;30;0;118
8315;22;66;30;0;118
8317;0;30;30;0;60
8318;22;30;0;0;52
8319;0;0;0;0;0
8320;0;66;30;0;96
8321;32;114;0;0;146
8322;0;44;0;0;44
8323;0;278;66;0;344
8324;0;0;30;0;30
8325;252;1042;338;0;1632
8326;0;20;30;0;50
8327;0;0;0;0;0
8328;0;0;0;0;0
8329;58;0;30;0;88
8330;0;0;10;0;10
8331;145;616;352;0;1113
8334;13;118;44;0;175
8335;0;68;44;0;112
8336;56;88;44;0;188
8337;8;0;22;0;30
8338;5;36;44;0;85
8339;162;594;264;0;1020
8340;0;0;44;0;44
8341;0;44;44;0;88
8342;0;6;22;0;28
8344;0;44;22;0;66
8345;221;431;440;0;1092
8346;170;505;390;0;1065
8348;268;344;1005;0;1617
8349;410;1191;484;0;2085
8351;325;781;221;0;1327
8352;184;490;396;0;1070
8353;362;310;264;0;936
8354;0;88;88;0;176
8355;44;108;88;0;240
8356;140;285;132;0;557
8357;60;88;176;0;324
8358;45;172;176;0;393
8360;0;0;0;0;0
8361;0;44;170;0;214
8362;0;132;44;0;176
8363;0;0;0;0;0
8365;190;358;450;0;998
8366;135;368;135;0;638
8367;270;794;526;0;1590
8368;330;1319;438;0;2087
8369;360;360;513;0;1233
8370;0;132;44;0;176
8371;0;132;44;0;176
8372;0;44;88;0;132
8373;0;0;42;0;42
8374;69;512;176;0;757
8375;118;883;418;0;1419
8376;163;1012;440;0;1615
8377;113;796;264;0;1173
8379;57;176;132;0;365
8380;290;591;264;0;1145
8382;24;112;121;0;257
8384;97;533;260;0;890
8385;0;0;0;0;0
8386;0;0;0;0;0
8388;352;767;308;0;1427
8389;0;132;88;0;220
8390;140;132;88;0;360
8391;172;264;264;0;700
8392;244;660;220;0;1124
8393;0;0;88;0;88
8394;114;352;264;0;730
8397;0;44;44;0;88
8398;44;88;132;0;264
8399;0;0;0;0;0
8401;20;0;132;0;152
8403;37;104;132;0;273
8404;80;88;176;0;344
8405;0;44;88;0;132
8407;0;0;44;0;44
8408;370;492;308;0;1170
8409;120;308;176;0;604
8410;88;310;176;0;574
8411;190;575;154;0;919
8412;352;704;264;0;1320
8413;177;551;132;0;860
8415;396;352;220;0;968
8416;84;132;44;0;260
8417;44;515;132;0;691
8419;0;0;44;0;44
8420;8;0;44;0;52
8421;461;1114;495;0;2070
8422;157;372;315;0;844
8423;90;180;90;0;360
8424;287;702;352;0;1341
8425;144;730;352;0;1226
8426;0;176;88;0;264
8427;350;676;440;0;1466
8429;218;528;338;0;1084
8430;192;308;264;0;764
8432;342;306;385;0;1033
8433;352;1082;308;0;1742
8434;224;862;176;0;1262
8435;531;616;308;0;1455
8436;104;998;176;0;1278
8437;225;717;264;0;1206
8438;155;1299;220;0;1674
8439;352;702;264;0;1318
8440;0;0;0;0;0
8441;360;864;368;0;1592
8442;297;1380;396;0;2073
8443;324;584;128;0;1036
8444;337;414;264;0;1015
8446;0;0;0;0;0
8447;0;0;0;0;0
8448;194;412;88;0;694
8449;235;318;132;0;685
8450;94;247;86;0;427
8452;0;0;44;0;44
8453;0;0;0;0;0
8454;341;717;920;0;1978
8455;198;697;657;0;1552
8456;0;0;0;0;0
8457;71;625;546;0;1242
8458;320;1019;278;0;1617
8460;0;0;0;0;0
8463;135;495;945;0;1575
8464;30;1033;0;0;1063
8467;16;0;0;0;16
8468;80;177;176;0;433
8470;0;88;85;0;173
8473;0;0;0;0;0
8474;126;352;338;0;816
8475;406;991;264;0;1661
8478;0;0;0;0;0
8479;97;132;132;0;361
8480;0;0;0;0;0
8482;0;0;0;0;0
8483;360;730;792;0;1882
8484;0;0;44;0;44
8485;484;2288;1584;0;4356
8486;0;0;0;0;0
8487;60;1522;836;0;2418
8488;264;726;396;0;1386
8489;88;533;440;0;1061
8490;136;840;528;0;1504
8491;188;1584;1012;0;2784
8492;132;924;484;0;1540
8494;88;308;220;0;616
8495;153;577;352;0;1082
8496;164;508;308;0;980
8497;307;852;514;0;1673
8498;114;924;572;0;1610
8499;299;1841;1496;0;3636
8500;360;572;308;0;1240
8501;213;660;264;0;1137
8502;241;220;178;0;639
8503;155;781;484;0;1420
8504;105;354;266;0;725
8505;110;516;264;0;890
8506;0;495;268;0;763
8507;80;484;352;0;916
8508;0;220;132;0;352
8510;97;352;324;0;773
8511;231;442;404;0;1077
8513;224;499;220;0;943
8514;345;413;352;0;1110
8515;222;220;132;0;574
8518;374;728;298;0;1400
8519;80;309;244;0;633
8520;240;514;396;0;1150
8521;570;925;264;0;1759
8522;167;770;308;0;1245
8523;101;396;308;0;805
8524;0;0;0;0;0
8525;0;0;0;0;0
8529;62;804;176;0;1042
8530;208;680;264;0;1152
8531;278;572;264;0;1114
8532;117;440;308;0;865
8533;194;434;440;0;1068
8535;173;632;220;0;1025
8536;190;708;176;0;1074
8537;475;750;264;0;1489
8540;132;174;132;0;438
8541;134;138;0;0;272
8542;120;660;396;0;1176
8544;758;843;426;0;2027
8546;295;836;528;0;1659
8547;475;132;176;0;783
8548;325;440;308;0;1073
8549;139;440;308;0;887
8550;0;0;0;0;0
8551;0;0;0;0;0
8552;182;1193;352;0;1727
8553;158;498;264;0;920
8554;152;389;308;0;849
8555;141;206;176;0;523
8556;583;606;352;0;1541
8558;852;264;348;0;1464
8561;152;396;176;0;724
8562;197;456;176;0;829
8563;120;484;308;0;912
8564;0;426;176;0;602
8565;0;0;0;0;0
8567;0;0;0;0;0
8568;0;0;0;0;0
8569;174;554;264;0;992
8571;42;44;44;0;130
8572;70;264;132;0;466
8573;0;0;0;0;0
8575;0;0;0;0;0
8576;94;352;176;0;622
8577;0;0;0;0;0
8579;242;544;176;0;962
8581;91;440;264;0;795
8583;0;0;0;0;0
8584;0;0;0;0;0
8585;104;132;132;0;368
8586;319;880;264;0;1463
8587;242;438;264;0;944
8589;661;541;938;0;2140
8590;0;0;0;0;0
8592;108;506;757;0;1371
8593;0;0;0;0;0
8598;0;121;45;0;166
8601;0;44;44;0;88
8603;111;615;405;0;1131
8604;202;756;426;0;1384
8609;0;0;0;0;0
8611;226;535;513;0;1274
8612;0;0;0;0;0
8613;48;259;252;0;559
8614;148;680;680;0;1508
8615;352;460;270;0;1082
8616;181;336;135;0;652
8617;999;284;438;0;1721
8618;0;276;135;0;411
8620;30;180;135;0;345
8621;0;0;0;0;0
8623;50;88;45;0;183
8625;115;590;431;0;1136
8626;0;0;0;0;0
8627;304;1806;585;0;2695
8629;168;858;385;0;1411
8630;0;0;0;0;0
8631;162;788;270;0;1220
8632;164;922;531;0;1617
8634;328;253;375;0;956
8635;0;0;0;0;0
8636;125;573;530;0;1228
8639;90;256;135;0;481
8642;0;0;0;0;0
8643;218;340;358;0;916
8644;108;299;225;0;632
8645;371;1153;833;0;2357
8646;0;0;0;0;0
8647;0;0;0;0;0
8648;0;0;0;0;0
8649;163;345;225;0;733
8650;45;45;225;0;315
8652;8;815;360;0;1183
8653;0;0;0;0;0
8654;0;225;90;0;315
8656;0;0;0;0;0
8657;280;644;405;0;1329
8658;70;623;270;0;963
8659;201;200;180;0;581
8660;0;0;0;0;0
8661;90;445;269;0;804
8663;0;435;180;0;615
8665;150;324;224;0;698
8666;186;409;235;0;830
8667;0;0;0;0;0
8670;0;0;0;0;0
8671;122;382;270;0;774
8673;0;0;0;0;0
8674;120;326;315;0;761
8675;439;434;438;0;1311
8676;152;732;155;0;1039
8677;0;0;0;0;0
8678;163;294;212;0;669
8680;44;620;225;0;889
8681;1;1195;270;0;1466
8682;0;757;313;0;1070
8684;40;389;90;0;519
8685;399;952;603;0;1954
8689;0;0;0;0;0
8690;292;320;285;0;897
8693;0;0;0;0;0
8695;0;0;0;0;0
8697;297;281;741;0;1319
8699;0;192;45;0;237
8700;15;0;119;0;134
8703;48;437;135;0;620
8706;69;80;225;0;374
8707;0;0;0;0;0
8709;0;0;0;0;0
8712;0;0;0;0;0
8714;27;315;135;0;477
8715;75;201;135;0;411
8716;0;0;0;0;0
8717;36;140;68;0;244
8718;112;150;86;0;348
8720;79;531;360;0;970
8721;126;376;45;0;547
8724;20;193;0;0;213
8725;60;69;120;0;249
8726;135;135;135;0;405
8728;219;460;225;0;904
8734;0;0;0;0;0
8739;0;33;180;0;213
8740;56;616;405;0;1077
8748;838;1300;1103;0;3241
8749;0;0;0;0;0
8750;0;45;319;0;364
8751;0;0;0;0;0
8754;0;0;0;0;0
8755;45;595;360;0;1000
8756;180;720;810;0;1710
8757;0;0;0;0;0
8758;0;0;0;0;0
8759;77;170;135;0;382
8760;0;0;0;0;0
8761;1494;225;989;0;2708
8762;43;353;0;0;396
8763;0;0;0;0;0
8764;0;0;0;0;0
8765;0;0;0;0;0
8768;0;45;45;0;90
8769;218;396;745;0;1359
8771;0;0;0;0;0
8772;0;0;0;0;0
8773;0;0;0;0;0
8775;0;0;0;0;0
8780;0;172;45;0;217
8781;0;0;45;0;45
8782;0;0;0;0;0
8787;0;0;0;0;0
8788;0;0;0;0;0
8789;0;0;0;0;0
8791;0;557;318;0;875
8792;0;0;0;0;0
8793;0;0;0;0;0
8795;0;0;0;0;0
8797;0;0;0;0;0
8800;31;327;135;0;493
8807;0;0;0;0;0
8809;0;0;0;0;0
8810;0;0;0;0;0
8811;79;110;225;0;414
8812;340;225;495;0;1060
8813;90;630;90;0;810
8814;167;176;220;0;563
8815;788;1078;924;0;2790
8816;0;0;0;0;0
8818;69;968;45;0;1082
8819;100;644;220;0;964
8821;478;1404;440;0;2322
8822;707;616;318;0;1641
8823;0;0;0;0;0
8824;0;0;0;0;0
8825;652;1090;640;0;2382
8826;0;0;0;0;0
8827;176;340;309;0;825
8828;405;1880;88;0;2373
8830;0;0;0;0;0
8831;0;0;0;0;0
8832;289;748;220;0;1257
8833;126;282;0;0;408
8835;308;924;396;0;1628
8837;356;250;176;0;782
8839;147;69;110;0;326
8840;17;104;132;0;253
8841;934;420;555;0;1909
8842;0;0;0;0;0
8843;0;0;0;0;0
8844;0;0;0;0;0
8845;80;42;45;0;167
8846;0;577;315;0;892
8849;187;844;45;0;1076
8852;0;0;0;0;0
8853;0;0;0;0;0
8854;164;259;385;0;808
8856;0;0;0;0;0
8859;0;0;0;0;0
8860;0;0;0;0;0
8861;99;420;135;0;654
8862;0;0;0;0;0
8863;0;135;0;0;135
8866;0;0;0;0;0
8867;0;0;0;0;0
8868;0;0;0;0;0
8869;306;857;761;0;1924
8870;0;0;0;0;0
8871;82;345;604;0;1031
8872;191;687;876;0;1754
8873;0;0;0;0;0
8876;0;0;0;0;0
8877;0;0;0;0;0
8878;774;1043;1035;0;2852
8880;0;0;0;0;0
8881;0;0;0;0;0
8883;0;90;90;0;180
8885;0;0;0;0;0
8888;894;469;0;0;1363
8889;0;0;0;0;0
8891;0;0;0;0;0
8892;126;87;45;0;258
8893;0;0;44;0;44
8894;0;0;0;0;0
8895;80;0;45;0;125
8899;0;0;0;0;0
8900;0;0;0;0;0
8902;0;0;0;0;0
8903;933;636;965;0;2534
8904;1238;0;855;0;2093
8905;0;0;0;0;0
8906;274;896;405;0;1575
8908;0;0;0;0;0
8909;359;178;0;0;537
8911;0;630;360;0;990
8912;0;0;0;0;0
8913;0;0;0;0;0
8914;75;314;135;0;524
8916;0;0;0;0;0
8917;1864;375;407;0;2646
8919;44;0;0;0;44
8921;250;385;450;0;1085
8922;0;0;0;0;0
8923;476;1908;1818;0;4202
8924;0;0;0;0;0
8925;118;660;572;0;1350
8926;176;748;528;0;1452
8927;0;748;706;0;1454
8928;303;1922;1144;0;3369
8930;342;836;528;0;1706
8931;148;549;220;0;917
8933;175;896;528;0;1599
8934;113;266;132;0;511
8935;0;0;0;0;0
8936;152;255;308;0;715
8938;45;359;422;0;826
8941;0;0;0;0;0
8942;329;1176;468;0;1973
8943;0;0;0;0;0
8944;129;372;340;0;841
8945;205;402;205;0;812
8949;0;0;0;0;0
8950;0;45;0;0;45
8951;0;0;0;0;0
8952;0;0;0;0;0
8953;0;0;0;0;0
8954;461;524;815;0;1800
8955;169;414;180;0;763
8956;0;246;45;0;291
8957;0;44;0;0;44
8958;0;0;0;0;0
8959;0;0;0;0;0
8962;0;0;0;0;0
8964;0;0;0;0;0
8965;0;0;0;0;0
8966;546;1058;906;0;2510
8967;0;0;0;0;0
8969;0;0;0;0;0
8970;237;482;359;0;1078
8971;0;0;0;0;0
8972;0;0;0;0;0
8974;319;600;269;0;1188
8978;0;0;0;0;0
8979;38;958;1202;0;2198
8981;132;942;390;0;1464
8982;0;0;0;0;0
8983;0;0;0;0;0
8984;132;124;0;0;256
8986;17;288;135;0;440
8987;0;0;0;0;0
8988;20;208;0;0;228
8989;0;0;0;0;0
8991;1055;705;771;0;2531
8992;562;188;538;0;1288
8993;0;0;0;0;0
8995;0;0;0;0;0
8996;0;0;0;0;0
8997;0;62;70;0;132
8998;0;45;0;0;45
9001;0;0;0;0;0
9003;875;351;1020;0;2246
9004;0;45;0;0;45
9005;0;0;0;0;0
9006;208;1172;484;0;1864
9007;107;572;220;0;899
9008;172;524;220;0;916
9010;150;692;220;0;1062
9011;94;442;220;0;756
9012;135;608;176;0;919
9013;227;592;308;0;1127
9017;93;468;255;0;816
9020;338;572;270;0;1180
9022;0;0;0;0;0
9023;0;0;0;0;0
9025;0;90;180;0;270
9026;157;495;45;0;697
9027;0;0;0;0;0
9029;0;0;0;0;0
9032;65;4;44;0;113
9033;89;744;450;0;1283
9035;0;0;0;0;0
9036;101;632;325;0;1058
9038;0;0;0;0;0
9039;44;0;332;0;376
9041;0;0;0;0;0
9042;0;0;0;0;0
9043;0;0;0;0;0
9046;44;44;0;0;88
9049;0;0;0;0;0
9050;0;0;0;0;0
9051;1158;895;900;0;2953
9052;0;0;0;0;0
9053;0;0;0;0;0
9054;0;936;0;0;936
9056;0;0;0;0;0
9057;0;0;0;0;0
9058;139;362;358;0;859
9060;215;450;450;0;1115
9061;262;135;585;0;982
9063;45;563;495;0;1103
9064;170;267;133;0;570
9065;287;220;176;0;683
9066;0;0;0;0;0
9067;0;0;0;0;0
9069;260;628;308;0;1196
9070;344;748;132;0;1224
9071;40;396;308;0;744
9072;88;690;308;0;1086
9073;602;1012;968;0;2582
9074;526;704;528;0;1758
9075;79;484;264;0;827
9077;148;176;264;0;588
9078;106;440;264;0;810
9082;208;308;44;0;560
9083;284;308;663;0;1255
9084;200;513;264;0;977
9085;293;494;264;0;1051
9086;140;406;88;0;634
9087;133;612;414;0;1159
9088;697;792;902;0;2391
9089;208;544;44;0;796
9090;118;352;176;0;646
9091;233;470;176;0;879
9092;0;0;0;0;0
9094;0;0;0;0;0
9095;0;0;0;0;0
9096;0;0;0;0;0
9097;134;528;132;0;794
9098;253;462;299;0;1014
9099;0;0;0;0;0
9100;563;868;220;0;1651
9102;340;334;176;0;850
9103;151;374;220;0;745
9104;269;566;264;0;1099
9105;394;506;220;0;1120
9106;241;646;572;0;1459
9107;193;132;118;0;443
9108;0;0;0;0;0
9110;464;176;132;0;772
9111;146;176;352;0;674
9116;146;82;220;0;448
9117;164;412;264;0;840
9119;0;0;0;0;0
9120;0;0;0;0;0
9121;194;400;396;0;990
9122;218;302;308;0;828
9123;0;0;0;0;0
9124;0;0;0;0;0
9125;278;789;308;0;1375
9127;316;528;211;0;1055
9128;118;892;220;0;1230
9131;195;562;176;0;933
9134;0;0;0;0;0
9135;44;35;0;0;79
9137;56;136;72;0;264
9140;152;651;108;0;911
9142;0;110;159;0;269
9144;0;225;214;0;439
9145;7;49;45;0;101
9146;156;147;225;0;528
9147;242;1238;405;0;1885
9149;0;0;0;0;0
9150;304;489;519;0;1312
9151;87;40;90;0;217
9152;0;0;0;0;0
9153;120;90;45;0;255
9155;0;0;0;0;0
9156;4;60;0;0;64
9158;377;945;450;0;1772
9159;109;172;405;0;686
9161;0;0;0;0;0
9162;269;1120;75;0;1464
9164;190;136;45;0;371
9165;60;240;191;0;491
9166;0;0;0;0;0
9168;172;526;347;0;1045
9169;0;0;0;0;0
9171;97;318;247;0;662
9172;42;70;180;0;292
9173;0;0;0;0;0
9175;90;174;135;0;399
9177;0;120;90;0;210
9179;174;457;315;0;946
9180;0;0;0;0;0
9181;0;0;0;0;0
9182;513;135;225;0;873
9183;164;195;179;0;538
9184;30;338;385;0;753
9185;145;669;1068;0;1882
9187;45;4;90;0;139
9189;16;43;86;0;145
9190;35;79;45;0;159
9194;244;368;405;0;1017
9197;153;554;225;0;932
9198;0;0;0;0;0
9200;180;473;225;0;878
9201;45;127;88;0;260
9204;32;45;90;0;167
9205;34;149;211;0;394
9206;0;787;515;0;1302
9208;222;441;180;0;843
9209;374;589;450;0;1413
9212;16;8;40;0;64
9213;55;660;315;0;1030
9216;0;0;0;0;0
9217;159;427;216;0;802
9218;0;25;90;0;115
9221;413;396;0;0;809
9222;0;0;0;0;0
9223;0;0;0;0;0
9225;0;0;0;0;0
9226;0;0;0;0;0
9227;0;0;0;0;0
9228;0;0;0;0;0
9229;0;0;0;0;0
9230;0;0;0;0;0
9231;0;0;0;0;0
9232;0;0;0;0;0
9236;0;0;0;0;0
9237;1253;192;1391;0;2836
9239;0;0;0;0;0
9240;0;0;0;0;0
9242;0;0;0;0;0
9244;0;0;0;0;0
9245;0;0;0;0;0
9246;797;472;1215;0;2484
9249;483;665;810;0;1958
9250;45;45;0;0;90
9252;0;0;0;0;0
9254;0;0;0;0;0
9259;75;764;360;0;1199
9262;0;0;0;0;0
9263;30;45;161;0;236
9265;0;0;0;0;0
9267;0;0;0;0;0
9268;58;150;30;0;238
9270;0;0;0;0;0
9271;0;0;0;0;0
9273;0;0;0;0;0
9275;0;0;0;0;0
9276;262;650;308;0;1220
9277;0;0;0;0;0
9278;400;225;450;0;1075
9280;0;0;0;0;0
9281;282;792;630;0;1704
9282;64;308;360;0;732
9283;489;1097;1350;0;2936
9284;175;552;540;0;1267
9285;177;397;495;0;1069
9287;0;0;0;0;0
9288;247;442;674;0;1363
9289;71;520;270;0;861
9290;190;397;494;0;1081
9291;0;0;0;0;0
9292;294;813;674;0;1781
9293;188;440;540;0;1168
9294;0;485;314;0;799
9295;0;0;0;0;0
9296;130;352;583;0;1065
9297;0;0;0;0;0
9298;211;720;675;0;1606
9299;73;440;360;0;873
9302;60;445;450;0;955
9303;0;0;0;0;0
9304;126;236;315;0;677
9306;0;132;315;0;447
9307;136;352;405;0;893
9308;199;315;269;0;783
9311;75;0;250;0;325
9312;675;1427;855;0;2957
9313;0;0;0;0;0
9317;288;450;675;0;1413
9318;0;270;45;0;315
9323;0;0;0;0;0
9324;344;168;220;0;732
9326;0;0;0;0;0
9327;0;0;0;0;0
9328;231;409;450;0;1090
9330;198;245;265;0;708
9331;681;1130;630;0;2441
9332;290;268;462;0;1020
9333;0;195;135;0;330
9334;393;179;180;0;752
9335;33;155;45;0;233
9337;20;90;45;0;155
9338;0;0;0;0;0
9339;0;89;45;0;134
9340;0;987;567;0;1554
9341;71;410;135;0;616
9342;24;169;315;0;508
9343;0;0;0;0;0
9344;0;0;0;0;0
9345;0;30;70;0;100
9347;315;747;405;0;1467
9348;14;193;135;0;342
9349;0;0;0;0;0
9350;0;0;0;0;0
9351;0;0;0;0;0
9355;0;0;0;0;0
9356;108;1200;270;0;1578
9357;0;0;0;0;0
9358;122;45;160;0;327
9360;0;0;0;0;0
9362;80;620;135;0;835
9363;144;177;120;0;441
9366;242;866;0;0;1108
9368;38;174;135;0;347
9369;142;510;340;0;992
9372;0;0;0;0;0
9373;79;1038;90;0;1207
9375;71;141;62;0;274
9376;72;45;90;0;207
9377;307;325;360;0;992
9379;0;0;0;0;0
9380;0;0;0;0;0
9381;0;0;0;0;0
9382;0;0;0;0;0
9383;0;0;0;0;0
9385;335;135;495;0;965
9386;0;0;0;0;0
9387;0;0;0;0;0
9388;0;0;0;0;0
9389;0;0;0;0;0
9391;0;0;0;0;0
9393;0;0;0;0;0
9394;0;0;0;0;0
9396;0;0;0;0;0
9397;0;0;0;0;0
9402;0;0;0;0;0
9404;0;0;0;0;0
9405;230;597;315;0;1142
9406;427;270;404;0;1101
9407;385;450;315;0;1150
9408;158;383;264;0;805
9409;119;396;360;0;875
9410;97;264;308;0;669
9411;381;520;440;0;1341
9412;0;0;0;0;0
9413;172;423;180;0;775
9414;66;414;68;0;548
9415;138;542;269;0;949
9416;232;208;176;0;616
9418;292;216;132;0;640
9419;238;256;264;0;758
9421;254;258;206;0;718
9422;146;148;132;0;426
9423;0;0;0;0;0
9424;220;998;88;0;1306
9426;72;512;315;0;899
9427;0;0;0;0;0
9428;203;206;220;0;629
9429;80;542;0;0;622
9430;168;320;132;0;620
9431;133;390;313;0;836
9433;191;325;180;0;696
9436;0;0;0;0;0
9437;134;396;176;0;706
9438;0;0;0;0;0
9439;0;0;0;0;0
9443;110;294;264;0;668
9444;232;223;135;0;590
9445;0;0;0;0;0
9446;138;178;132;0;448
9452;0;0;0;0;0
9453;0;0;0;0;0
9457;206;444;176;0;826
9458;163;400;220;0;783
9459;0;0;0;0;0
9460;80;224;180;0;484
9461;20;45;0;0;65
9467;40;45;80;0;165
9468;0;0;0;0;0
9469;0;0;0;0;0
9471;0;0;0;0;0
9472;79;1500;625;0;2204
9473;83;97;100;0;280
9474;193;145;480;0;818
9476;0;0;0;0;0
9477;0;0;0;0;0
9480;0;0;0;0;0
9481;0;0;0;0;0
9483;0;0;0;0;0
9484;195;523;360;0;1078
9485;0;145;33;0;178
9486;116;442;442;0;1000
9487;0;85;0;0;85
9488;0;0;0;0;0
9489;0;45;135;0;180
9490;10;128;45;0;183
9499;243;405;396;0;1044
9500;110;190;469;0;769
9502;144;805;270;0;1219
9503;133;340;260;0;733
9504;599;378;1305;0;2282
9505;0;551;224;0;775
9506;88;402;90;0;580
9507;187;242;361;0;790
9508;0;45;45;0;90
9509;0;44;0;0;44
9510;125;481;225;0;831
9511;0;30;77;0;107
9512;0;45;45;0;90
9513;0;0;0;0;0
9516;0;0;0;0;0
9517;0;0;0;0;0
9518;38;45;45;0;128
9519;349;724;495;0;1568
9520;88;25;50;0;163
9521;0;0;0;0;0
9524;0;0;0;0;0
9525;0;0;0;0;0
9526;0;0;0;0;0
9527;59;508;45;0;612
9528;0;0;0;0;0
9531;24;45;20;0;89
9533;82;44;88;0;214
9534;270;732;290;0;1292
9535;0;0;0;0;0
9536;101;198;180;0;479
9537;12;280;169;0;461
9539;0;150;90;0;240
9540;0;66;52;0;118
9543;0;40;45;0;85
9544;15;209;190;0;414
9547;180;135;135;0;450
9549;0;0;0;0;0
9550;0;0;0;0;0
9551;45;185;120;0;350
9553;141;202;99;0;442
9554;0;0;0;0;0
9556;82;140;271;0;493
9557;0;0;0;0;0
9558;204;462;205;0;871
9562;0;0;0;0;0
9564;22;684;485;0;1191
9565;0;0;0;0;0
9566;0;0;0;0;0
9567;0;0;0;0;0
9569;0;0;0;0;0
9570;249;145;484;0;878
9572;135;0;90;0;225
9573;0;0;0;0;0
9574;162;1044;300;0;1506
9579;180;450;90;0;720
9581;154;440;220;0;814
9582;303;308;264;0;875
9583;348;264;440;0;1052
9584;70;308;176;0;554
9585;85;245;264;0;594
9586;239;605;220;0;1064
9587;370;558;308;0;1236
9588;129;352;220;0;701
9589;0;0;0;0;0
9590;266;371;176;0;813
9591;436;292;308;0;1036
9592;162;315;220;0;697
9593;141;299;176;0;616
9595;146;685;396;0;1227
9596;0;0;0;0;0
9597;244;396;308;0;948
9598;178;546;396;0;1120
9599;589;759;264;0;1612
9600;205;504;176;0;885
9601;218;462;264;0;944
9602;198;530;396;0;1124
9603;0;0;0;0;0
9604;490;704;484;0;1678
9605;199;388;220;0;807
9606;333;220;220;0;773
9607;132;220;220;0;572
9608;125;284;176;0;585
9609;102;221;265;0;588
9610;273;352;396;0;1021
9611;226;364;176;0;766
9612;258;308;352;0;918
9614;232;378;220;0;830
9616;209;880;484;0;1573
9617;478;497;264;0;1239
9618;486;527;396;0;1409
9620;366;308;308;0;982
9621;0;0;0;0;0
9625;232;496;176;0;904
9626;30;88;220;0;338
9629;220;501;264;0;985
9631;271;264;308;0;843
9634;857;986;540;0;2383
9635;45;45;45;0;135
9636;315;1070;520;0;1905
9637;126;1735;183;0;2044
9638;219;334;267;0;820
9639;65;443;135;0;643
9642;30;870;450;0;1350
9643;0;73;80;0;153
9646;55;290;135;0;480
9647;471;590;1150;0;2211
9648;30;170;90;0;290
9653;49;240;135;0;424
9654;24;750;270;0;1044
9655;45;413;266;0;724
9656;275;735;314;0;1324
9659;398;951;450;0;1799
9660;593;780;630;0;2003
9663;62;282;135;0;479
9664;56;80;455;0;591
9665;125;765;315;0;1205
9666;265;658;45;0;968
9667;0;45;45;0;90
9668;0;178;45;0;223
9669;54;45;145;0;244
9673;0;789;224;0;1013
9674;84;180;45;0;309
9676;52;90;135;0;277
9680;89;363;315;0;767
9681;0;0;0;0;0
9684;94;703;551;0;1348
9685;75;225;135;0;435
9686;231;304;225;0;760
9687;208;426;308;0;942
9688;240;482;264;0;986
9690;98;484;308;0;890
9691;0;0;0;0;0
9693;891;798;352;0;2041
9694;333;132;178;0;643
9695;230;220;264;0;714
9697;207;356;264;0;827
9698;347;306;220;0;873
9699;151;784;132;0;1067
9700;319;430;132;0;881
9701;396;421;176;0;993
9702;320;370;264;0;954
9703;168;432;132;0;732
9704;131;90;176;0;397
9705;353;362;132;0;847
9706;320;202;88;0;610
9707;0;0;0;0;0
9709;264;236;176;0;676
9710;120;310;176;0;606
9713;167;214;132;0;513
9714;231;432;132;0;795
9715;215;298;132;0;645
9716;152;576;250;0;978
9717;209;338;201;0;748
9718;129;335;216;0;680
9719;261;398;264;0;923
9720;629;780;308;0;1717
9721;240;410;250;0;900
9722;63;260;88;0;411
9726;182;356;352;0;890
9727;278;0;132;0;410
9728;60;176;132;0;368
9729;164;202;220;0;586
9730;295;148;176;0;619
9732;0;0;0;0;0
9733;258;535;176;0;969
9734;207;457;308;0;972
9736;536;338;220;0;1094
9738;222;358;220;0;800
9740;226;388;176;0;790
9741;197;472;132;0;801
9743;0;0;0;0;0
9744;0;0;0;0;0
9745;0;0;0;0;0
9747;34;118;88;0;240
9748;0;0;0;0;0
9749;0;0;0;0;0
9750;249;275;359;0;883
9752;0;0;0;0;0
9754;271;96;225;0;592
9755;0;0;0;0;0
9757;266;684;450;0;1400
9758;297;772;315;0;1384
9759;347;159;579;0;1085
9760;0;0;0;0;0
9762;0;0;0;0;0
9766;190;185;323;0;698
9767;147;569;585;0;1301
9768;438;1525;615;0;2578
9770;0;0;0;0;0
9771;43;387;368;0;798
9772;26;103;225;0;354
9777;0;0;0;0;0
9778;135;1053;637;0;1825
9779;90;705;210;0;1005
9780;270;815;225;0;1310
9781;354;1434;1350;0;3138
9782;0;0;0;0;0
9784;0;45;135;0;180
9785;0;0;0;0;0
9786;207;684;270;0;1161
9788;150;0;255;0;405
9789;79;25;45;0;149
9791;0;0;33;0;33
9792;0;0;0;0;0
9794;0;0;0;0;0
9796;315;693;282;0;1290
9797;206;569;315;0;1090
9799;673;785;1060;0;2518
9800;44;611;268;0;923
9801;120;609;315;0;1044
9803;0;214;90;0;304
9804;0;45;45;0;90
9805;90;155;116;0;361
9807;0;85;110;0;195
9808;22;269;45;0;336
9809;0;140;90;0;230
9810;164;826;350;0;1340
9811;0;808;460;0;1268
9812;0;0;0;0;0
9813;0;0;0;0;0
9814;0;0;0;0;0
9816;25;153;270;0;448
9817;0;260;134;0;394
9818;0;0;0;0;0
9819;0;0;0;0;0
9822;0;0;0;0;0
9824;169;505;450;0;1124
9825;44;0;101;0;145
9826;10;91;80;0;181
9827;115;760;405;0;1280
9828;60;478;225;0;763
9829;87;200;235;0;522
9830;0;45;45;0;90
9832;0;0;0;0;0
9834;195;2037;945;0;3177
9841;120;853;356;0;1329
9842;0;90;0;0;90
9844;190;675;465;0;1330
9845;320;908;225;0;1453
9847;44;1107;314;0;1465
9850;0;30;44;0;74
9852;225;945;650;0;1820
9853;553;782;395;0;1730
9855;0;420;360;0;780
9856;0;0;0;0;0
9858;0;0;0;0;0
9859;175;348;225;0;748
9860;45;359;45;0;449
9861;374;960;778;0;2112
9862;239;778;572;0;1589
9863;500;414;397;0;1311
9864;336;479;352;0;1167
9865;321;447;514;0;1282
9866;124;396;315;0;835
9867;543;572;352;0;1467
9869;205;472;220;0;897
9870;108;296;244;0;648
9872;284;589;352;0;1225
9873;584;458;220;0;1262
9874;105;336;244;0;685
9875;189;360;88;0;637
9876;325;194;220;0;739
9877;275;308;176;0;759
9878;639;435;254;0;1328
9879;391;672;264;0;1327
9880;166;392;220;0;778
9881;591;339;177;0;1107
9882;280;628;420;0;1328
9883;376;497;270;0;1143
9884;299;676;133;0;1108
9886;118;217;376;0;711
9887;150;197;132;0;479
9888;129;276;244;0;649
9889;335;529;309;0;1173
9890;357;591;353;0;1301
9891;155;710;220;0;1085
9892;442;535;176;0;1153
9893;286;527;177;0;990
9895;582;437;266;0;1285
9896;171;264;436;0;871
9897;314;1055;315;0;1684
9898;0;0;0;0;0
9900;127;960;135;0;1222
9901;20;75;217;0;312
9902;132;240;45;0;417
9903;184;225;360;0;769
9905;80;119;185;0;384
9906;0;314;90;0;404
9907;0;421;270;0;691
9909;190;2658;1395;0;4243
9910;135;135;180;0;450
9911;240;928;505;0;1673
9912;153;415;395;0;963
9913;61;112;135;0;308
9916;54;269;109;0;432
9917;467;1194;539;0;2200
9919;384;143;300;0;827
9920;0;127;45;0;172
9922;38;856;225;0;1119
9923;89;45;251;0;385
9924;462;747;955;0;2164
9925;0;0;0;0;0
9926;181;454;295;0;930
9928;0;88;90;0;178
9930;101;390;220;0;711
9932;0;80;90;0;170
9936;0;0;0;0;0
9937;48;657;697;0;1402
9939;50;543;340;0;933
9940;236;760;571;0;1567
9941;0;90;180;0;270
9942;127;315;315;0;757
9943;0;0;44;0;44
9945;211;115;295;0;621
9946;25;113;88;0;226
9947;507;321;579;0;1407
9948;120;0;77;0;197
9950;206;554;168;0;928
9953;30;0;180;0;210
9955;89;297;358;0;744
9957;133;450;270;0;853
9959;355;2590;990;0;3935
9960;53;255;90;0;398
9963;175;448;225;0;848
9967;135;435;225;0;795
9968;45;90;90;0;225
9970;0;0;0;0;0
9972;90;265;180;0;535
9973;374;259;586;0;1219
9974;0;0;0;0;0
9975;0;0;0;0;0
9976;0;0;0;0;0
9979;24;45;90;0;159
9980;0;0;0;0;0
9981;180;225;180;0;585
9982;134;267;177;0;578
9984;0;0;0;0;0
9985;43;448;382;0;873
9986;89;308;220;0;617
9987;22;172;264;0;458
9990;0;0;0;0;0
9991;45;186;248;0;479
9992;83;532;308;0;923
9993;117;607;220;0;944
9994;43;398;176;0;617
9995;105;300;248;0;653
9996;31;178;88;0;297
9998;248;496;344;0;1088
9999;26;247;176;0;449
10000;49;434;264;0;747
10001;40;316;132;0;488
10004;0;0;0;0;0
10005;164;818;220;0;1202
10006;54;436;300;0;790
10008;0;0;0;0;0
10009;0;0;0;0;0
10010;333;192;660;0;1185
10012;38;248;176;0;462
10014;37;17;90;0;144
10015;0;210;345;0;555
10018;104;0;90;0;194
10019;77;40;40;0;157
10021;57;165;180;0;402
10023;131;453;270;0;854
10026;36;236;130;0;402
10028;115;145;90;0;350
10029;0;0;0;0;0
10030;256;909;448;0;1613
10031;0;0;0;0;0
10032;57;480;164;0;701
10035;104;333;90;0;527
10036;135;423;87;0;645
10041;34;183;45;0;262
10042;0;567;270;0;837
10044;238;488;270;0;996
10046;270;509;405;0;1184
10050;0;0;0;0;0
10052;89;315;135;0;539
10053;0;0;0;0;0
10056;63;477;135;0;675
10058;58;288;269;0;615
10059;0;0;0;0;0
10063;45;214;90;0;349
10064;25;280;120;0;425
10066;0;0;0;0;0
10068;0;0;0;0;0
10069;70;885;180;0;1135
10070;0;0;0;0;0
10072;0;0;0;0;0
10073;0;399;88;0;487
10074;92;294;176;0;562
10075;87;438;308;0;833
10076;471;624;704;0;1799
10077;294;616;308;0;1218
10078;0;0;0;0;0
10080;137;1082;225;0;1444
10081;359;1330;308;0;1997
10083;221;634;176;0;1031
10085;248;939;354;0;1541
10086;124;416;220;0;760
10087;127;510;220;0;857
10088;177;340;176;0;693
10089;318;660;352;0;1330
10090;313;639;264;0;1216
10091;431;734;440;0;1605
10092;138;596;572;0;1306
10093;139;323;484;0;946
10094;0;0;0;0;0
10095;80;244;352;0;676
10097;176;542;338;0;1056
10098;155;420;264;0;839
10099;109;340;176;0;625
10100;186;328;180;0;694
10102;37;387;308;0;732
10103;336;618;396;0;1350
10104;207;605;443;0;1255
10105;195;756;528;0;1479
10106;396;590;440;0;1426
10107;76;542;176;0;794
10108;73;264;220;0;557
10109;154;418;217;0;789
10110;0;0;0;0;0
10111;0;0;0;0;0
10112;0;0;0;0;0
10113;331;574;574;0;1479
10114;296;156;602;0;1054
10116;316;662;220;0;1198
10117;128;408;308;0;844
10118;0;0;0;0;0
10119;231;382;572;0;1185
10120;133;605;401;0;1139
10121;163;373;177;0;713
10122;196;570;176;0;942
10123;219;926;220;0;1365
10124;362;377;434;0;1173
10125;62;220;220;0;502
10126;230;308;328;0;866
10127;250;540;528;0;1318
10128;56;64;132;0;252
10130;248;506;355;0;1109
10133;0;88;45;0;133
10134;112;699;135;0;946
10135;142;536;266;0;944
10136;0;0;0;0;0
10139;0;0;0;0;0
10140;35;343;199;0;577
10142;58;44;105;0;207
10143;168;350;135;0;653
10147;74;196;45;0;315
10148;0;0;0;0;0
10149;93;270;159;0;522
10150;0;0;0;0;0
10151;188;640;180;0;1008
10152;225;1215;135;0;1575
10155;120;260;268;0;648
10156;84;339;261;0;684
10157;135;270;90;0;495
10158;239;405;627;0;1271
10159;0;375;180;0;555
10160;62;366;445;0;873
10162;135;765;360;0;1260
10164;410;996;345;0;1751
10167;135;495;312;0;942
10168;91;491;451;0;1033
10171;19;103;40;0;162
10172;76;529;90;0;695
10173;213;45;135;0;393
10176;37;182;44;0;263
10181;0;0;0;0;0
10182;134;178;90;0;402
10183;172;141;30;0;343
10184;0;0;0;0;0
10186;40;184;254;0;478
10187;362;748;862;0;1972
10190;0;0;0;0;0
10191;40;45;45;0;130
10193;90;895;450;0;1435
10195;0;0;0;0;0
10196;0;492;45;0;537
10197;218;312;225;0;755
10199;217;470;396;0;1083
10200;284;789;450;0;1523
10201;329;476;315;0;1120
10202;239;617;269;0;1125
10203;0;0;0;0;0
10204;158;225;302;0;685
10205;134;267;180;0;581
10207;382;488;662;0;1532
10210;154;357;417;0;928
10211;0;0;0;0;0
10212;115;299;401;0;815
10216;295;179;314;0;788
10217;32;95;45;0;172
10218;0;0;0;0;0
10219;42;143;45;0;230
10220;286;300;268;0;854
10221;0;240;90;0;330
10222;0;0;0;0;0
10223;157;272;270;0;699
10224;0;736;225;0;961
10225;0;254;88;0;342
10226;160;875;180;0;1215
10228;210;888;225;0;1323
10229;30;60;44;0;134
10232;237;732;314;0;1283
10233;0;359;135;0;494
10234;51;70;90;0;211
10235;120;240;90;0;450
10236;0;0;0;0;0
10237;0;0;0;0;0
10239;272;812;308;0;1392
10240;786;1052;616;0;2454
10241;530;220;528;0;1278
10242;0;0;0;0;0
10245;318;536;232;0;1086
10246;558;1443;675;0;2676
10247;160;1700;495;0;2355
10248;248;202;220;0;670
10249;0;0;0;0;0
10250;612;558;564;0;1734
10251;190;342;393;0;925
10252;224;592;220;0;1036
10253;163;480;624;0;1267
10254;44;550;220;0;814
10255;88;602;438;0;1128
10257;142;509;264;0;915
10259;235;375;397;0;1007
10260;232;138;216;0;586
10262;151;528;426;0;1105
10263;140;148;220;0;508
10264;161;210;264;0;635
10265;94;204;264;0;562
10266;329;432;308;0;1069
10267;88;626;422;0;1136
10268;64;660;250;0;974
10269;140;352;333;0;825
10270;149;782;378;0;1309
10271;165;88;302;0;555
10272;653;473;1002;0;2128
10273;137;259;264;0;660
10274;0;0;0;0;0
10277;387;955;692;0;2034
10278;233;132;197;0;562
10279;118;220;254;0;592
10280;172;126;214;0;512
10281;91;276;338;0;705
10282;16;396;264;0;676
10283;177;202;484;0;863
10284;0;0;0;0;0
10285;518;264;662;0;1444
10286;0;0;0;0;0
10288;196;118;220;0;534
10290;589;394;602;0;1585
10291;163;484;250;0;897
10293;284;164;133;0;581
10295;0;0;0;0;0
10300;141;132;206;0;479
10301;116;206;250;0;572
10302;146;514;114;0;774
10305;366;470;442;0;1278
10306;93;280;236;0;609
10307;151;528;338;0;1017
10309;226;808;308;0;1342
10312;0;0;0;0;0
10313;262;594;450;0;1306
10314;0;0;0;0;0
10315;280;804;621;0;1705
10320;385;1039;540;0;1964
10321;0;50;45;0;95
10322;0;0;0;0;0
10324;252;980;477;0;1709
10326;119;300;360;0;779
10327;262;1039;380;0;1681
10328;0;0;0;0;0
10329;120;285;225;0;630
10330;0;0;0;0;0
10331;0;263;180;0;443
10332;120;866;380;0;1366
10333;243;796;419;0;1458
10334;134;90;435;0;659
10335;45;55;45;0;145
10336;45;1026;388;0;1459
10337;115;557;495;0;1167
10338;135;678;315;0;1128
10340;0;0;0;0;0
10341;63;166;90;0;319
10343;0;0;0;0;0
10344;135;585;345;0;1065
10345;186;231;212;0;629
10346;0;0;87;0;87
10348;8;135;225;0;368
10349;0;0;0;0;0
10350;140;300;452;0;892
10351;315;362;180;0;857
10352;90;510;405;0;1005
10353;0;61;45;0;106
10355;54;264;264;0;582
10358;0;0;0;0;0
10359;206;481;313;0;1000
10361;120;465;225;0;810
10362;90;45;180;0;315
10363;0;25;25;0;50
10364;96;784;280;0;1160
10365;66;237;170;0;473
10371;0;0;0;0;0
10372;20;0;115;0;135
10375;8;45;315;0;368
10376;45;65;62;0;172
10377;165;220;135;0;520
10384;45;0;45;0;90
10385;63;580;300;0;943
10386;52;75;112;0;239
10388;0;0;0;0;0
10393;0;0;0;0;0
10394;0;0;0;0;0
10395;0;0;0;0;0
10396;67;464;270;0;801
10397;88;396;308;0;792
10398;153;176;44;0;373
10399;230;704;674;0;1608
10400;447;567;315;0;1329
10401;232;582;360;0;1174
10402;0;221;45;0;266
10403;182;400;270;0;852
10404;238;328;135;0;701
10405;346;714;495;0;1555
10407;246;350;180;0;776
10408;94;396;315;0;805
10409;136;118;210;0;464
10410;184;284;180;0;648
10411;178;412;180;0;770
10412;0;180;135;0;315
10413;60;389;171;0;620
10415;135;605;315;0;1055
10416;162;855;225;0;1242
10418;0;0;0;0;0
10419;108;572;450;0;1130
10420;132;871;268;0;1271
10421;44;542;225;0;811
10422;74;965;225;0;1264
10424;72;610;135;0;817
10425;63;982;223;0;1268
10426;88;433;90;0;611
10427;60;488;90;0;638
10428;58;340;89;0;487
10429;121;476;179;0;776
10430;70;665;269;0;1004
10431;52;365;70;0;487
10432;125;808;717;0;1650
10433;110;512;224;0;846
10434;0;0;0;0;0
10435;144;133;267;0;544
10436;40;224;134;0;398
10439;10;45;45;0;100
10441;20;180;90;0;290
10442;10;45;89;0;144
10443;134;169;132;0;435
10444;60;485;177;0;722
10447;118;568;315;0;1001
10449;0;96;0;0;96
10450;346;1188;572;0;2106
10451;0;0;0;0;0
10452;89;528;352;0;969
10453;98;882;308;0;1288
10455;134;660;308;0;1102
10456;109;660;308;0;1077
10457;168;1008;132;0;1308
10458;129;1144;176;0;1449
10459;104;660;220;0;984
10460;2815;1104;132;0;4051
10461;105;792;176;0;1073
10462;206;894;440;0;1540
10464;40;608;220;0;868
10465;566;220;220;0;1006
10466;0;0;0;0;0
10467;0;0;0;0;0
10469;0;0;0;0;0
10470;267;878;264;0;1409
10472;178;484;88;0;750
10473;75;792;264;0;1131
10474;159;1584;88;0;1831
10475;244;924;176;0;1344
10476;118;1130;88;0;1336
10478;33;270;315;0;618
10479;0;550;270;0;820
10480;22;90;90;0;202
10481;0;0;0;0;0
10482;236;210;342;0;788
10484;110;421;355;0;886
10486;0;0;0;0;0
10487;837;2712;1890;0;5439
10488;191;430;283;0;904
10489;327;718;515;0;1560
10490;0;0;0;0;0
10491;192;665;445;0;1302
10492;355;207;322;0;884
10493;90;225;180;0;495
10494;0;0;0;0;0
10495;270;349;315;0;934
10496;270;355;370;0;995
10497;279;992;315;0;1586
10498;0;0;0;0;0
10500;290;540;435;0;1265
10501;0;486;225;0;711
10502;224;458;315;0;997
10503;110;867;347;0;1324
10505;205;756;405;0;1366
10506;238;847;260;0;1345
10507;224;267;223;0;714
10509;0;0;0;0;0
10512;45;222;135;0;402
10513;90;0;90;0;180
10515;84;288;500;0;872
10516;238;652;264;0;1154
10517;0;0;0;0;0
10519;144;432;220;0;796
10520;538;704;396;0;1638
10522;108;176;176;0;460
10524;102;388;176;0;666
10525;0;0;0;0;0
10526;222;299;341;0;862
10527;335;542;440;0;1317
10528;188;176;88;0;452
10529;127;244;177;0;548
10530;174;296;264;0;734
10531;0;0;0;0;0
10532;0;0;30;0;30
10533;0;0;0;0;0
10534;0;0;0;0;0
10536;213;170;221;0;604
10537;59;284;177;0;520
10538;0;0;0;0;0
10540;198;346;370;0;914
10541;428;300;397;0;1125
10542;355;969;540;0;1864
10543;250;470;495;0;1215
10544;413;656;495;0;1564
10545;208;352;494;0;1054
10546;226;905;225;0;1356
10547;193;281;314;0;788
10548;196;696;360;0;1252
10550;155;729;360;0;1244
10551;120;296;450;0;866
10553;541;664;352;0;1557
10554;91;526;306;0;923
10555;81;861;88;0;1030
10556;203;626;360;0;1189
10557;52;505;220;0;777
10558;137;444;180;0;761
10559;300;377;220;0;897
10560;180;646;405;0;1231
10561;168;366;308;0;842
10563;156;442;360;0;958
10564;178;606;270;0;1054
10565;290;1330;762;0;2382
10567;145;176;270;0;591
10568;194;502;132;0;828
10569;159;555;530;0;1244
10570;164;354;270;0;788
10571;345;987;315;0;1647
10572;105;142;132;0;379
10573;194;133;309;0;636
10574;49;264;135;0;448
10576;104;176;180;0;460
10577;408;1130;359;0;1897
10578;347;709;450;0;1506
10579;239;490;360;0;1089
10580;195;636;290;0;1121
10581;224;521;315;0;1060
10584;289;649;210;0;1148
10585;0;0;0;0;0
10586;196;687;335;0;1218
10587;0;0;0;0;0
10588;365;701;495;0;1561
10589;107;388;450;0;945
10590;115;312;90;0;517
10592;317;533;405;0;1255
10594;60;435;248;0;743
10595;110;522;155;0;787
10596;0;0;0;0;0
10599;0;0;0;0;0
10600;392;693;213;0;1298
10601;90;45;45;0;180
10603;0;0;0;0;0
10604;257;361;180;0;798
10606;239;474;458;0;1171
10607;246;476;338;0;1060
10608;88;542;900;0;1530
10610;64;569;405;0;1038
10611;90;377;410;0;877
10614;0;0;0;0;0
10615;0;126;180;0;306
10618;340;1053;495;0;1888
10619;55;45;90;0;190
10621;355;1735;540;0;2630
10622;53;180;85;0;318
10623;65;0;445;0;510
10625;420;705;270;0;1395
10626;75;488;225;0;788
10628;0;315;90;0;405
10629;48;162;45;0;255
10631;153;446;130;0;729
10632;170;630;304;0;1104
10634;0;0;0;0;0
10635;639;223;855;0;1717
10636;0;0;0;0;0
10638;1508;1376;1146;0;4030
10639;0;0;0;0;0
10640;317;302;398;0;1017
10641;578;355;340;0;1273
10642;192;177;444;0;813
10643;276;404;179;0;859
10645;298;458;223;0;979
10646;250;460;134;0;844
10648;276;219;135;0;630
10649;318;281;263;0;862
10651;320;653;224;0;1197
10652;257;300;44;0;601
10654;0;0;0;0;0
10655;146;223;134;0;503
10656;318;190;222;0;730
10657;0;0;0;0;0
10658;923;2402;1077;0;4402
10659;36;50;45;0;131
10660;36;148;90;0;274
10661;43;330;59;0;432
10662;90;45;90;0;225
10663;189;622;352;0;1163
10665;168;632;176;0;976
10666;267;641;308;0;1216
10667;206;1155;304;0;1665
10668;258;248;286;0;792
10669;338;690;220;0;1248
10670;0;0;0;0;0
10671;112;534;242;0;888
10672;44;342;132;0;518
10673;114;440;308;0;862
10674;168;280;170;0;618
10675;96;326;88;0;510
10676;130;126;170;0;426
10677;200;206;132;0;538
10679;106;378;88;0;572
10680;0;608;176;0;784
10682;0;0;0;0;0
10683;0;270;135;0;405
10684;0;0;0;0;0
10685;208;173;391;0;772
10686;138;970;630;0;1738
10687;66;939;225;0;1230
10688;125;958;45;0;1128
10689;263;250;88;0;601
10692;80;413;135;0;628
10693;0;0;0;0;0
10694;25;0;0;0;25
10696;409;984;394;0;1787
10697;269;836;440;0;1545
10698;171;248;88;0;507
10699;310;901;258;0;1469
10701;0;0;0;0;0
10702;91;423;84;0;598
10703;102;220;88;0;410
10704;261;632;261;0;1154
10705;139;270;132;0;541
10706;183;272;121;0;576
10708;0;0;0;0;0
10710;110;787;405;0;1302
10711;132;220;540;0;892
10712;0;260;90;0;350
10713;189;645;495;0;1329
10715;225;495;180;0;900
10716;0;194;135;0;329
10717;213;236;224;0;673
10719;0;0;0;0;0
10720;0;0;0;0;0
10721;122;1663;675;0;2460
10722;83;204;135;0;422
10723;88;25;312;0;425
10724;0;0;0;0;0
10725;422;506;360;0;1288
10726;540;761;345;0;1646
10727;374;516;312;0;1202
10729;442;803;314;0;1559
10730;148;362;90;0;600
10732;0;0;0;0;0
10733;0;0;0;0;0
10734;380;464;411;0;1255
10735;387;720;396;0;1503
10736;224;264;220;0;708
10737;272;352;88;0;712
10738;236;944;308;0;1488
10740;145;352;176;0;673
10741;160;528;176;0;864
10742;80;936;317;0;1333
10743;84;187;154;0;425
10744;221;390;165;0;776
10746;273;176;176;0;625
10747;348;230;132;0;710
10748;412;976;464;0;1852
10749;490;734;352;0;1576
10750;375;1499;387;0;2261
10751;396;220;264;0;880
10752;199;480;88;0;767
10753;238;206;176;0;620
10754;489;373;352;0;1214
10755;220;440;220;0;880
10756;289;256;132;0;677
10757;105;647;630;0;1382
10758;384;394;413;0;1191
10760;339;310;308;0;957
10761;0;0;0;0;0
10763;304;352;132;0;788
10764;270;465;132;0;867
10765;28;25;44;0;97
10766;141;320;176;0;637
10767;85;859;160;0;1104
10768;30;432;135;0;597
10769;141;261;572;0;974
10771;34;252;109;0;395
10772;232;473;225;0;930
10773;160;1339;687;0;2186
10774;15;121;45;0;181
10777;0;0;0;0;0
10778;169;582;88;0;839
10779;0;0;0;0;0
10780;358;730;396;0;1484
10781;176;574;484;0;1234
10782;203;325;293;0;821
10783;359;966;308;0;1633
10784;88;124;294;0;506
10785;71;294;132;0;497
10786;117;0;176;0;293
10787;0;0;0;0;0
10789;227;128;88;0;443
10790;271;410;220;0;901
10791;408;602;389;0;1399
10792;425;448;375;0;1248
10794;65;362;119;0;546
10795;183;296;88;0;567
10796;169;0;88;0;257
10797;103;190;172;0;465
10798;81;363;88;0;532
10799;65;109;248;0;422
10800;8;4;22;0;34
10801;0;0;0;0;0
10803;0;0;0;0;0
10805;81;0;136;0;217
10806;0;0;0;0;0
10810;67;40;166;0;273
10811;0;0;0;0;0
10815;0;0;0;0;0
10816;88;162;131;0;381
10818;80;30;186;0;296
10820;0;0;0;0;0
10821;79;44;153;0;276
10822;0;0;0;0;0
10824;0;0;0;0;0
10825;8;0;40;0;48
10827;120;190;340;0;650
10828;377;884;184;0;1445
10829;210;733;330;0;1273
10830;274;282;288;0;844
10831;99;1185;360;0;1644
10832;1095;2572;1622;0;5289
10833;334;777;513;0;1624
10834;83;163;393;0;639
10835;201;648;180;0;1029
10836;233;480;180;0;893
10837;149;246;166;0;561
10838;60;326;90;0;476
10839;194;396;134;0;724
10840;116;402;135;0;653
10841;0;0;0;0;0
10842;299;960;308;0;1567
10844;294;892;308;0;1494
10845;423;484;528;0;1435
10846;114;220;176;0;510
10848;194;430;176;0;800
10849;0;12;88;0;100
10850;0;0;0;0;0
10851;0;456;315;0;771
10852;165;278;397;0;840
10853;0;0;0;0;0
10854;323;1218;352;0;1893
10855;0;0;0;0;0
10856;56;172;88;0;316
10858;121;184;74;0;379
10859;0;0;0;0;0
10861;30;152;0;0;182
10862;47;118;88;0;253
10863;0;0;0;0;0
10864;86;124;52;0;262
10865;74;125;44;0;243
10866;0;0;0;0;0
10867;0;0;0;0;0
10868;84;106;44;0;234
10869;23;0;44;0;67
10870;4;0;44;0;48
10871;50;68;44;0;162
10872;0;0;0;0;0
10873;276;989;340;0;1605
10876;0;0;0;0;0
10877;44;202;88;0;334
10878;9;286;133;0;428
10879;22;310;133;0;465
10880;0;294;132;0;426
10881;130;140;115;0;385
10882;0;0;0;0;0
10883;0;0;0;0;0
10884;77;355;167;0;599
10885;0;0;0;0;0
10887;0;0;0;0;0
10889;129;423;75;0;627
10892;669;3930;450;0;5049
10893;180;698;359;0;1237
10894;0;0;0;0;0
10897;0;0;0;0;0
10898;0;45;45;0;90
10900;246;521;285;0;1052
10901;234;690;180;0;1104
10902;0;0;0;0;0
10904;0;0;0;0;0
10905;137;584;88;0;809
10906;60;285;180;0;525
10908;0;0;0;0;0
10909;0;0;0;0;0
10911;537;620;224;0;1381
10912;0;0;0;0;0
10913;147;134;134;0;415
10914;0;0;0;0;0
10915;456;604;970;0;2030
10916;52;221;132;0;405
10917;179;1436;359;0;1974
10918;0;0;0;0;0
10956;163;383;90;0;636
10959;0;0;0;0;0
10960;0;0;0;0;0
10962;488;675;630;0;1793
10963;177;975;315;0;1467
10964;0;0;0;0;0
10967;153;308;360;0;821
10968;382;611;660;0;1653
10970;133;575;630;0;1338
10971;0;0;0;0;0
10973;30;139;40;0;209
10974;94;0;114;0;208
10975;0;132;45;0;177
10976;0;169;55;0;224
10977;0;0;0;0;0
10979;0;0;0;0;0
11025;51;440;88;0;579
11027;0;0;44;0;44
11028;0;0;0;0;0
11029;0;0;0;0;0
11030;0;0;0;0;0
11031;0;0;0;0;0
11032;64;303;180;0;547
11033;132;806;264;0;1202
11034;352;602;264;0;1218
11035;0;0;0;0;0
11036;0;44;0;0;44
11038;250;670;118;0;1038
11097;0;0;0;0;0
11098;0;0;0;0;0
11100;0;0;0;0;0
11102;0;0;0;0;0
11103;82;480;206;0;768
11105;518;1064;225;0;1807
11106;426;1148;902;0;2476
11107;0;193;452;0;645
11110;29;308;176;0;513
11111;198;660;352;0;1210
11113;0;0;0;0;0
11114;45;125;45;0;215
11116;0;44;0;0;44
11117;0;0;0;0;0
11120;0;0;0;0;0
11122;0;0;0;0;0
11124;0;0;0;0;0
11127;0;0;0;0;0
11128;0;0;0;0;0
11130;297;394;435;0;1126
11133;40;152;45;0;237
11136;9;0;0;0;9
11138;0;0;0;0;0
11139;222;748;264;0;1234
11144;926;998;360;0;2284
11145;327;253;312;0;892
11147;173;158;225;0;556
11148;0;0;0;0;0
11151;0;0;0;0;0
11153;0;0;12;0;12
11154;0;0;0;0;0
11155;422;722;480;0;1624
11156;0;0;0;0;0
11157;45;164;30;0;239
11176;110;1418;315;0;1843
11177;318;902;305;0;1525
11178;135;315;225;0;675
11180;35;0;135;0;170
11182;0;0;0;0;0
11185;0;0;0;0;0
11186;0;0;0;0;0
11187;0;0;0;0;0
11188;0;0;0;0;0
11191;0;0;0;0;0
11194;0;0;44;0;44
11196;0;30;82;0;112
11199;144;858;220;0;1222
11200;0;44;40;0;84
11201;0;189;80;0;269
11203;68;328;90;0;486
11204;0;0;0;0;0
11205;10;90;40;0;140
11206;0;44;11;0;55
11209;45;390;225;0;660
11210;0;0;0;0;0
11212;0;0;0;0;0
11214;62;325;45;0;432
11217;0;225;185;0;410
11218;0;0;0;0;0
11219;0;0;0;0;0
11220;51;170;115;0;336
11221;0;0;0;0;0
11223;107;225;45;0;377
11224;61;270;90;0;421
11226;0;0;0;0;0
11228;0;0;0;0;0
11230;0;0;0;0;0
11231;0;0;0;0;0
11232;0;0;0;0;0
11234;0;0;0;0;0
11235;0;0;0;0;0
11237;25;419;360;0;804
11238;0;0;0;0;0
11240;25;407;340;0;772
11241;30;90;115;0;235
11242;75;279;77;0;431
11243;0;0;0;0;0
11244;0;0;0;0;0
11245;23;285;44;0;352
11246;30;118;88;0;236
11248;232;270;149;0;651
11251;0;0;0;0;0
11255;0;0;0;0;0
11256;122;472;569;0;1163
11257;0;0;0;0;0
11258;0;0;0;0;0
11261;130;1002;88;0;1220
11263;109;318;132;0;559
11265;255;1285;540;0;2080
11267;0;0;0;0;0
11268;0;0;0;0;0
11273;0;0;0;0;0
11277;156;687;220;0;1063
11279;0;0;44;0;44
11283;16;76;74;0;166
11284;110;462;220;0;792
11285;0;0;0;0;0
11286;260;529;308;0;1097
11287;399;784;324;0;1507
11290;0;0;0;0;0
11291;0;223;135;0;358
11316;0;0;0;0;0
11317;0;0;0;0;0
11318;0;85;120;0;205
11319;0;0;0;0;0
11320;0;0;0;0;0
11322;0;0;0;0;0
11323;290;294;420;0;1004
11324;0;0;0;0;0
11325;0;0;0;0;0
11329;0;0;0;0;0
11330;209;555;302;0;1066
11332;0;0;0;0;0
11333;29;88;44;0;161
11334;0;0;0;0;0
11335;0;0;0;0;0
11336;127;396;222;0;745
11337;0;66;88;0;154
11338;442;44;250;0;736
11339;90;683;252;0;1025
11340;0;0;0;0;0
11342;165;797;289;0;1251
11343;93;418;135;0;646
11344;130;219;155;0;504
11346;0;0;0;0;0
11347;30;532;88;0;650
11348;30;285;135;0;450
11349;0;0;0;0;0
11350;8;45;44;0;97
11352;20;0;41;0;61
11388;0;169;45;0;214
11389;0;0;0;0;0
11390;0;0;0;0;0
11391;0;0;0;0;0
11392;0;0;0;0;0
11394;751;796;352;0;1899
11395;10;0;82;0;92
11396;0;0;0;0;0
11397;78;874;180;0;1132
11398;276;380;264;0;920
11399;0;36;0;0;36
11400;66;529;132;0;727
11401;48;90;45;0;183
11402;0;0;0;0;0
11403;0;0;0;0;0
11404;0;0;0;0;0
11405;351;1650;440;0;2441
11406;0;0;0;0;0
11407;357;128;44;0;529
11408;90;80;45;0;215
11410;0;0;0;0;0
11411;0;0;0;0;0
11413;0;0;0;0;0
11414;4;120;38;0;162
11415;0;0;0;0;0
11416;0;0;0;0;0
11417;210;332;177;0;719
11418;0;0;0;0;0
11419;0;44;0;0;44
11420;57;505;135;0;697
11421;0;0;0;0;0
11422;0;0;0;0;0
11423;0;0;0;0;0
11424;0;0;0;0;0
11425;0;0;38;0;38
11427;0;0;0;0;0
11428;0;0;0;0;0
11429;97;212;45;0;354
11430;240;1027;609;0;1876
11431;30;135;45;0;210
11433;0;0;0;0;0
11450;0;0;0;0;0
11461;0;0;0;0;0
11462;64;88;44;0;196
11463;0;0;0;0;0
11464;0;0;0;0;0
11465;83;65;90;0;238
11466;0;0;0;0;0
11467;101;408;135;0;644
11469;0;0;0;0;0
11471;8;117;180;0;305
11472;258;730;221;0;1209
11473;0;0;22;0;22
11497;0;0;0;0;0
11498;132;1386;225;0;1743
11501;55;38;42;0;135
11509;114;646;251;0;1011
11511;0;0;0;0;0
11518;0;0;0;0;0
11520;39;216;132;0;387
11522;0;100;0;0;100
11523;0;0;0;0;0
11526;0;88;0;0;88
11527;118;684;225;0;1027
11528;0;25;8;0;33
11529;49;166;44;0;259
11530;34;421;74;0;529
11531;0;0;0;0;0
11532;0;0;0;0;0
11539;0;0;0;0;0
11540;0;45;38;0;83
11542;0;44;0;0;44
11543;0;0;44;0;44
11544;28;278;0;0;306
11545;0;0;0;0;0
11547;0;45;0;0;45
11548;88;697;264;0;1049
11549;0;0;0;0;0
11551;0;0;0;0;0
11553;21;27;44;0;92
11554;30;4;0;0;34
11556;0;0;0;0;0
11557;0;0;0;0;0
11558;0;0;0;0;0
11559;0;0;0;0;0
11560;0;0;0;0;0
11563;0;0;0;0;0
11565;0;0;0;0;0
11573;0;0;0;0;0
11574;0;0;0;0;0
11575;0;0;0;0;0
11576;0;0;0;0;0
11577;0;100;0;0;100
11578;36;44;0;0;80
11581;0;0;0;0;0
11582;0;0;0;0;0
11584;0;0;0;0;0
11587;0;0;0;0;0
11588;0;0;0;0;0
11589;0;0;0;0;0
11590;4;0;10;0;14
11591;178;816;258;0;1252
11592;0;0;0;0;0
11593;0;0;0;0;0
11594;125;176;176;0;477
11595;0;0;0;0;0
11602;0;0;0;0;0
11604;0;0;0;0;0
11606;0;0;0;0;0
11608;780;790;527;0;2097
11609;0;0;44;0;44
11612;240;814;176;0;1230
11673;0;0;0;0;0
11674;0;274;90;0;364
11675;16;154;30;0;200
11676;0;0;0;0;0
11677;242;1416;308;0;1966
11678;0;491;180;0;671
11680;106;429;315;0;850
11681;75;319;0;0;394
11682;0;0;0;0;0
11685;0;0;0;0;0
11686;0;0;0;0;0
11687;182;756;220;0;1158
11688;0;0;0;0;0
11704;322;1155;265;0;1742
11705;4;44;223;0;271
11706;483;422;290;0;1195
11707;329;389;301;0;1019
11708;117;310;165;0;592
11709;93;301;220;0;614
11710;14;123;45;0;182
11711;118;1994;375;0;2487
11712;309;860;522;0;1691
11713;0;0;0;0;0
11714;27;175;44;0;246
11715;178;360;495;0;1033
11716;97;273;135;0;505
11718;145;865;180;0;1190
11719;117;425;135;0;677
11737;0;0;0;0;0
11738;0;0;0;0;0
11739;0;320;30;0;350
11740;0;0;0;0;0
11741;78;47;185;0;310
11742;0;0;0;0;0
11743;402;235;177;0;814
11744;44;0;88;0;132
11745;0;72;32;0;104
11746;148;456;220;0;824
11749;0;0;0;0;0
11755;0;0;0;0;0
11758;0;0;0;0;0
11759;75;0;90;0;165
11760;0;0;0;0;0
11761;30;196;67;0;293
11762;0;0;0;0;0
11763;0;0;0;0;0
11766;0;0;0;0;0
11767;0;0;0;0;0
11768;4;0;0;0;4
11770;0;0;0;0;0
11772;0;0;0;0;0
11773;0;0;0;0;0
11775;0;0;0;0;0
11776;395;0;0;0;395
11778;0;0;0;0;0
11783;0;0;0;0;0
11786;0;0;0;0;0
11788;122;210;290;0;622
11789;150;651;265;0;1066
11791;4;70;45;0;119
11792;37;526;360;0;923
11793;90;150;45;0;285
11794;12;45;162;0;219
11795;0;144;175;0;319
11797;135;153;111;0;399
11800;121;315;0;0;436
11802;0;0;0;0;0
11804;16;0;135;0;151
11805;227;396;215;0;838
11806;0;84;90;0;174
11807;0;0;0;0;0
11808;0;0;0;0;0
11809;24;135;45;0;204
11811;25;44;44;0;113
11812;124;1078;270;0;1472
11813;0;44;59;0;103
11814;0;0;45;0;45
11816;0;0;0;0;0
11817;0;0;0;0;0
11818;188;1080;540;0;1808
11822;0;0;0;0;0
11825;0;0;0;0;0
11827;0;0;0;0;0
11828;74;135;90;0;299
11830;40;322;180;0;542
11831;56;573;352;0;981
11833;0;0;0;0;0
11835;28;350;135;0;513
11836;38;0;45;0;83
11837;77;615;210;0;902
11838;75;325;89;0;489
11839;0;0;0;0;0
11843;135;120;261;0;516
11845;70;641;217;0;928
11848;0;0;0;0;0
11850;0;0;0;0;0
11851;381;626;330;0;1337
11853;70;30;45;0;145
11854;87;335;135;0;557
11855;0;0;0;0;0
11856;0;0;0;0;0
11858;0;0;0;0;0
11860;0;0;0;0;0
11862;0;88;64;0;152
11864;0;0;0;0;0
11865;0;135;45;0;180
11867;55;594;75;0;724
11869;0;0;0;0;0
11870;86;270;250;0;606
11871;219;132;0;0;351
11878;59;255;45;0;359
11879;0;0;0;0;0
11881;0;0;0;0;0
11882;0;0;0;0;0
11883;273;418;210;0;901
11885;32;130;180;0;342
11886;93;374;170;0;637
11887;0;0;0;0;0
11890;0;0;0;0;0
11892;0;0;0;0;0
11893;0;0;0;0;0
11897;0;0;0;0;0
11898;0;0;0;0;0
11899;0;0;0;0;0
11901;6;25;0;0;31
11902;0;0;0;0;0
11903;0;0;0;0;0
11905;0;0;0;0;0
11906;239;160;135;0;534
11909;80;309;75;0;464
11910;0;0;0;0;0
11912;0;0;0;0;0
11914;0;612;270;0;882
11915;0;0;0;0;0
11918;62;132;135;0;329
11920;0;0;0;0;0
11921;0;22;0;0;22
11922;0;0;0;0;0
11923;45;45;45;0;135
11924;22;0;45;0;67
11925;0;0;0;0;0
11926;45;45;90;0;180
11928;40;124;40;0;204
11929;0;0;0;0;0
11931;150;383;190;0;723
11932;0;44;45;0;89
11934;0;0;0;0;0
11936;44;689;360;0;1093
11942;64;270;180;0;514
11943;0;0;0;0;0
11945;0;0;0;0;0
11946;0;0;0;0;0
11947;77;648;270;0;995
11948;0;0;0;0;0
11949;89;150;135;0;374
11950;8;135;45;0;188
11951;0;0;0;0;0
11952;204;270;265;0;739
11953;0;0;0;0;0
11956;0;0;0;0;0
11959;0;0;0;0;0
11960;0;0;0;0;0
11962;306;90;0;0;396
11965;887;1067;812;0;2766
11966;0;0;0;0;0
11967;0;0;0;0;0
11968;280;1355;413;0;2048
11971;0;0;0;0;0
11977;20;478;303;0;801
11978;0;0;0;0;0
11979;71;410;225;0;706
11980;0;85;449;0;534
11985;0;0;0;0;0
11987;0;0;0;0;0
11988;0;0;0;0;0
11991;0;0;0;0;0
11993;266;1074;528;0;1868
11994;103;262;437;0;802
11997;187;297;315;0;799
11998;81;32;132;0;245
12001;85;1230;360;0;1675
12002;82;540;544;0;1166
12003;0;0;0;0;0
12004;25;512;180;0;717
12005;174;450;270;0;894
12006;48;264;220;0;532
12008;224;885;585;0;1694
12010;0;0;0;0;0
12011;16;116;44;0;176
12013;0;0;0;0;0
12014;36;395;65;0;496
12015;0;44;0;0;44
12018;6;15;15;0;36
12019;0;0;0;0;0
12020;147;1393;308;0;1848
12021;0;0;0;0;0
12022;66;440;88;0;594
12023;146;146;221;0;513
12024;0;0;0;0;0
12025;0;0;0;0;0
12027;104;946;495;0;1545
12028;0;0;0;0;0
12029;0;0;0;0;0
12030;0;0;0;0;0
12031;54;727;155;0;936
12032;211;519;180;0;910
12033;283;1240;465;0;1988
12034;0;0;0;0;0
12035;0;0;88;0;88
12036;0;0;0;0;0
12037;122;995;275;0;1392
12038;0;0;0;0;0
12039;0;0;0;0;0
12041;0;0;0;0;0
12042;8;36;0;0;44
12045;0;0;0;0;0
12046;35;129;264;0;428
12047;0;0;0;0;0
12048;0;0;0;0;0
12050;314;460;259;0;1033
12051;72;318;132;0;522
12052;44;156;89;0;289
12053;0;0;0;0;0
12054;0;0;0;0;0
12055;0;0;0;0;0
12056;0;0;0;0;0
12058;489;759;748;0;1996
12059;0;469;45;0;514
12061;0;0;0;0;0
12062;385;535;540;0;1460
12063;160;1330;180;0;1670
12064;0;0;0;0;0
12065;0;22;0;0;22
12072;0;0;0;0;0
12073;0;0;0;0;0
12076;560;610;584;0;1754
12077;73;390;240;0;703
12079;168;798;450;0;1416
12080;0;0;0;0;0
12082;0;0;0;0;0
12083;192;338;225;0;755
12085;0;328;225;0;553
12086;180;135;315;0;630
12087;120;0;0;0;120
12089;0;0;0;0;0
12090;175;177;225;0;577
12092;97;374;180;0;651
12093;0;0;0;0;0
12094;42;290;135;0;467
12095;45;299;180;0;524
12096;0;0;0;0;0
12097;41;113;245;0;399
12100;0;0;0;0;0
12101;0;0;0;0;0
12102;0;90;45;0;135
12103;110;310;88;0;508
12104;0;0;0;0;0
12105;200;511;180;0;891
12108;37;84;205;0;326
12111;163;721;180;0;1064
12112;0;0;0;0;0
12113;254;347;180;0;781
12114;0;0;0;0;0
12115;115;423;270;0;808
12117;309;528;572;0;1409
12118;243;124;80;0;447
12119;24;165;45;0;234
12120;0;0;0;0;0
12121;10;45;0;0;55
12122;180;180;135;0;495
12126;213;515;173;0;901
12127;0;0;0;0;0
12130;30;143;70;0;243
12133;0;0;0;0;0
12134;0;0;0;0;0
12136;25;0;115;0;140
12137;0;0;0;0;0
12139;0;0;0;0;0
12143;32;52;98;0;182
12146;140;418;206;0;764
12151;178;938;462;0;1578
12152;0;0;0;0;0
12153;0;0;0;0;0
12154;0;0;0;0;0
12157;922;88;308;0;1318
12158;0;0;0;0;0
12159;0;0;0;0;0
12161;0;90;45;0;135
12162;0;0;0;0;0
12163;0;0;0;0;0
12165;0;0;0;0;0
12167;0;0;130;0;130
12168;0;0;0;0;0
12171;150;304;220;0;674
12175;30;109;125;0;264
12177;15;180;45;0;240
12178;0;0;0;0;0
12180;0;0;0;0;0
12182;0;45;45;0;90
12183;241;396;222;0;859
12184;0;0;122;0;122
12185;173;683;99;0;955
12187;0;0;0;0;0
12188;0;80;85;0;165
12189;0;0;0;0;0
12191;0;20;0;0;20
12192;405;2287;773;0;3465
12193;0;30;25;0;55
12217;267;630;700;0;1597
12218;0;0;0;0;0
12220;0;0;0;0;0
12221;8;49;0;0;57
12224;0;0;0;0;0
12225;438;768;360;0;1566
12226;0;0;0;0;0
12228;0;0;0;0;0
12230;0;0;0;0;0
12231;0;0;0;0;0
12232;0;0;0;0;0
12233;0;0;0;0;0
12234;44;0;44;0;88
12235;0;0;0;0;0
12237;213;116;90;0;419
12238;0;0;0;0;0
12239;0;0;0;0;0
12241;15;283;180;0;478
12242;45;495;270;0;810
12243;144;357;405;0;906
12244;42;410;175;0;627
12245;0;0;0;0;0
12246;0;0;0;0;0
12248;0;0;0;0;0
12249;154;264;172;0;590
12250;0;0;0;0;0
12251;173;374;176;0;723
12252;0;0;0;0;0
12254;0;0;0;0;0
12255;519;606;266;0;1391
12257;0;0;0;0;0
12258;0;0;0;0;0
12260;98;492;45;0;635
12261;0;0;0;0;0
12265;477;120;0;0;597
12266;0;0;0;0;0
12268;0;0;0;0;0
12269;0;0;0;0;0
12271;0;0;0;0;0
12272;0;0;0;0;0
12273;52;88;89;0;229
12293;0;0;0;0;0
12294;48;48;48;0;144
12295;180;256;225;0;661
12296;0;0;0;0;0
12299;0;44;0;0;44
12301;21;90;90;0;201
12302;67;376;45;0;488
12305;25;445;145;0;615
12306;0;0;0;0;0
12307;0;0;0;0;0
12308;0;0;0;0;0
12309;191;540;405;0;1136
12310;50;290;90;0;430
12311;15;55;36;0;106
12312;219;541;180;0;940
12313;0;0;0;0;0
12314;74;223;176;0;473
12315;0;0;0;0;0
12323;0;85;120;0;205
12325;0;0;0;0;0
12326;0;0;0;0;0
12328;99;341;45;0;485
12329;0;0;0;0;0
12330;116;165;110;0;391
12332;44;310;221;0;575
12333;0;0;0;0;0
12335;0;0;0;0;0
12336;220;264;236;0;720
12337;0;0;0;0;0
12363;0;0;0;0;0
12364;0;0;0;0;0
12366;162;813;132;0;1107
12367;0;0;0;0;0
12368;108;1230;270;0;1608
12501;320;931;358;0;1609
12502;0;0;0;0;0
12503;0;0;0;0;0
12504;105;680;180;0;965
12505;127;0;320;0;447
12506;0;0;0;0;0
12508;0;0;0;0;0
12509;20;430;180;0;630
12510;0;135;45;0;180
12511;0;80;0;0;80
12512;0;0;40;0;40
12514;0;0;0;0;0
12515;240;535;90;0;865
12518;270;965;450;0;1685
12519;0;60;64;0;124
12522;0;0;0;0;0
12523;0;60;45;0;105
12526;0;0;0;0;0
12529;0;0;0;0;0
12531;0;0;0;0;0
12533;0;0;0;0;0
12534;634;2836;0;0;3470
12535;0;0;0;0;0
12536;8;90;128;0;226
12537;0;60;30;0;90
12538;234;900;485;0;1619
12539;117;38;380;0;535
12540;0;0;0;0;0
12542;96;88;133;0;317
12545;0;135;0;0;135
12546;0;0;0;0;0
12547;283;1280;1044;0;2607
12548;0;0;0;0;0
12549;52;249;175;0;476
12550;133;176;44;0;353
12551;255;662;221;0;1138
12552;0;0;15;0;15
12553;0;0;77;0;77
12554;0;0;10;0;10
12555;30;0;150;0;180
12556;0;0;120;0;120
12557;20;45;90;0;155
12559;0;0;0;0;0
12560;0;0;0;0;0
12562;0;0;10;0;10
12563;0;0;0;0;0
12564;0;0;0;0;0
12565;0;0;0;0;0
12566;740;2784;581;0;4105
12567;442;1828;720;0;2990
12568;0;0;0;0;0
12569;13;165;55;0;233
12570;227;2216;360;0;2803
12571;0;0;0;0;0
12572;0;0;0;0;0
12573;385;290;135;0;810
12574;0;0;0;0;0
12576;0;0;0;0;0
12577;0;0;0;0;0
12578;0;0;0;0;0
12579;57;276;102;0;435
12580;0;0;0;0;0
12581;0;0;0;0;0
12582;0;0;0;0;0
12584;0;30;45;0;75
12585;0;0;0;0;0
12586;0;0;0;0;0
12587;110;758;645;0;1513
12588;300;426;180;0;906
12590;88;79;176;0;343
12591;123;270;135;0;528
12593;129;403;180;0;712
12594;179;435;225;0;839
12596;0;0;0;0;0
12597;0;0;0;0;0
12598;0;0;0;0;0
12599;0;60;30;0;90
12600;0;175;84;0;259
12601;0;0;0;0;0
12602;589;1488;315;0;2392
12603;170;840;495;0;1505
12604;93;1046;180;0;1319
12605;180;1160;495;0;1835
12606;0;90;45;0;135
12607;38;90;90;0;218
12609;11;0;99;0;110
12610;498;736;357;0;1591
12612;0;0;0;0;0
12613;22;198;75;0;295
12614;0;0;0;0;0
12615;0;0;0;0;0
12616;0;0;0;0;0
12617;396;1957;484;0;2837
12618;0;0;0;0;0
12619;0;75;45;0;120
12620;0;120;45;0;165
12621;0;0;126;0;126
12622;0;24;72;0;96
12623;290;1063;176;0;1529
12624;0;0;0;0;0
12626;0;0;0;0;0
12627;0;0;0;0;0
12628;0;0;0;0;0
12629;0;0;0;0;0
12630;367;1426;405;0;2198
12631;160;1780;585;0;2525
12632;858;2356;420;0;3634
12633;0;0;0;0;0
12634;135;360;135;0;630
12635;0;246;90;0;336
12636;0;0;0;0;0
12637;0;0;0;0;0
12638;102;450;270;0;822
12640;0;0;0;0;0
12641;0;0;0;0;0
12643;0;0;0;0;0
12644;0;0;0;0;0
12645;0;0;0;0;0
12646;20;270;90;0;380
12647;0;0;0;0;0
12648;40;152;30;0;222
12649;478;2257;90;0;2825
12650;130;1315;540;0;1985
12651;0;0;0;0;0
12652;741;1642;630;0;3013
12653;0;0;0;0;0
12654;0;0;0;0;0
12655;42;846;270;0;1158
12657;90;607;630;0;1327
12658;54;560;0;0;614
12659;229;633;240;0;1102
12660;47;294;67;0;408
12661;0;90;0;0;90
12662;0;0;0;0;0
12663;0;0;0;0;0
12664;0;0;44;0;44
12665;0;0;0;0;0
12666;0;0;0;0;0
12667;198;1004;945;0;2147
12668;0;10;0;0;10
12669;0;794;90;0;884
12670;85;90;45;0;220
12672;135;1145;405;0;1685
12674;0;20;0;0;20
12675;63;188;29;0;280
12676;0;0;0;0;0
12677;0;0;0;0;0
12678;0;44;44;0;88
12679;0;0;0;0;0
12680;0;353;45;0;398
12681;50;300;205;0;555
12682;171;1193;290;0;1654
12683;178;794;398;0;1370
12684;0;0;0;0;0
12685;208;720;135;0;1063
12686;475;1064;495;0;2034
12688;140;450;0;0;590
12689;0;0;0;0;0
12691;0;75;45;0;120
12692;0;0;0;0;0
12693;272;1785;135;0;2192
12694;211;255;225;0;691
12695;132;44;177;0;353
12696;0;135;0;0;135
12697;40;270;45;0;355
12698;25;88;45;0;158
12699;36;225;90;0;351
12700;0;180;45;0;225
12701;0;0;0;0;0
12702;0;80;35;0;115
12703;0;0;0;0;0
12704;0;75;30;0;105
12705;0;81;0;0;81
12707;0;0;0;0;0
12708;78;484;44;0;606
12709;65;153;45;0;263
12710;0;89;45;0;134
12711;0;465;0;0;465
12712;259;1430;495;0;2184
12713;424;1845;225;0;2494
12714;0;0;0;0;0
12715;322;1105;90;0;1517
12716;1139;495;505;0;2139
12717;44;340;45;0;429
12718;0;0;0;0;0
12719;119;843;306;0;1268
12720;290;233;225;0;748
12721;0;0;0;0;0
12722;0;0;44;0;44
12724;0;0;0;0;0
12725;29;265;45;0;339
12726;481;664;370;0;1515
12727;83;270;44;0;397
12728;0;261;129;0;390
12729;0;0;0;0;0
12730;0;90;0;0;90
12731;81;135;108;0;324
12732;62;135;67;0;264
12733;14;343;135;0;492
12734;174;636;225;0;1035
12735;512;816;0;0;1328
12736;32;392;90;0;514
12738;161;495;209;0;865
12739;88;817;132;0;1037
12741;20;124;258;0;402
12742;73;243;0;0;316
12743;0;0;0;0;0
12744;0;0;0;0;0
12746;22;225;45;0;292
12747;60;255;375;0;690
12748;90;165;45;0;300
12749;443;1595;535;0;2573
12750;45;65;0;0;110
12751;0;319;90;0;409
12752;0;0;0;0;0
12753;0;853;180;0;1033
12755;0;0;0;0;0
12756;0;0;0;0;0
12757;0;180;90;0;270
12758;140;359;355;0;854
12759;0;88;44;0;132
12760;0;0;0;0;0
12761;147;570;135;0;852
12762;152;300;208;0;660
12764;28;247;90;0;365
12765;22;157;40;0;219
12766;207;110;45;0;362
12767;24;412;90;0;526
12770;39;95;95;0;229
12772;233;297;0;0;530
12773;67;270;67;0;404
12774;83;45;225;0;353
12775;330;870;369;0;1569
12776;22;118;45;0;185
12777;0;75;135;0;210
12778;32;60;80;0;172
12779;0;83;273;0;356
12780;48;130;0;0;178
12781;0;550;466;0;1016
12800;295;270;405;0;970
12802;75;136;355;0;566
12805;0;0;25;0;25
12806;0;0;0;0;0
12808;0;0;0;0;0
12809;0;0;0;0;0
12810;174;429;391;0;994
12811;0;0;549;0;549
12812;0;0;0;0;0
12814;0;45;45;0;90
12815;0;0;0;0;0
12816;0;0;0;0;0
12819;0;0;0;0;0
12820;34;95;45;0;174
12822;223;423;308;0;954
12823;0;160;135;0;295
12824;0;0;0;0;0
12826;0;0;0;0;0
12827;0;0;0;0;0
12829;0;89;150;0;239
12830;44;405;270;0;719
12831;0;68;25;0;93
12832;0;0;0;0;0
12833;0;0;0;0;0
12834;0;0;0;0;0
12836;499;1295;765;0;2559
12837;230;658;270;0;1158
12838;235;655;225;0;1115
12840;441;784;616;0;1841
12842;140;521;264;0;925
12843;0;0;0;0;0
12845;0;60;0;0;60
12846;0;296;0;0;296
12847;0;0;0;0;0
12848;0;145;45;0;190
12850;0;0;0;0;0
12851;135;45;306;0;486
12853;45;460;450;0;955
12855;270;180;45;0;495
12857;0;0;0;0;0
12858;0;0;0;0;0
12859;0;0;0;0;0
12860;134;150;283;0;567
12861;0;180;45;0;225
12862;0;22;22;0;44
12863;0;0;0;0;0
12864;125;945;450;0;1520
12865;0;81;44;0;125
12867;0;180;0;0;180
12868;228;966;315;0;1509
12869;50;105;45;0;200
12870;396;528;528;0;1452
12871;188;260;505;0;953
12872;352;396;220;0;968
12875;0;0;0;0;0
12876;0;90;180;0;270
12877;0;0;0;0;0
12878;275;248;90;0;613
12879;22;135;45;0;202
12880;0;0;0;0;0
12881;0;0;0;0;0
12882;0;144;45;0;189
12884;0;0;0;0;0
12885;300;1475;585;0;2360
12886;64;219;90;0;373
12887;0;0;0;0;0
12888;273;320;180;0;773
12889;0;90;30;0;120
12890;20;192;22;0;234
12891;179;1919;855;0;2953
12931;0;0;0;0;0
12932;0;0;0;0;0
12934;0;0;47;0;47
12935;255;485;0;0;740
12936;175;450;180;0;805
12937;0;0;0;0;0
12938;0;0;0;0;0
12939;0;0;0;0;0
12940;0;0;0;0;0
12941;622;1110;352;0;2084
12942;546;572;1062;0;2180
12943;135;805;450;0;1390
12944;505;834;616;0;1955
12945;220;508;432;0;1160
12946;0;0;0;0;0
12948;44;100;44;0;188
12949;40;0;0;0;40
12951;265;90;155;0;510
12952;0;170;45;0;215
12953;58;38;247;0;343
12954;0;0;0;0;0
12955;143;300;90;0;533
12956;0;0;0;0;0
12957;0;0;0;0;0
12958;202;306;315;0;823
12959;76;292;82;0;450
12960;58;89;65;0;212
12961;88;396;225;0;709
12962;774;862;616;0;2252
12963;440;1410;565;0;2415
12965;0;0;0;0;0
12966;0;0;0;0;0
12967;70;111;67;0;248
12968;61;0;270;0;331
12969;0;45;67;0;112
12970;225;360;315;0;900
12971;28;225;45;0;298
12972;44;44;44;0;132
12973;0;0;0;0;0
12974;0;0;0;0;0
12975;0;50;0;0;50
12976;0;0;0;0;0
12977;165;815;302;0;1282
12979;0;90;45;0;135
12980;291;436;573;0;1300
12982;45;270;180;0;495
12983;142;0;0;0;142
12984;0;0;0;0;0
12985;0;0;0;0;0
12986;18;135;0;0;153
12987;0;45;163;0;208
13101;0;0;0;0;0
13102;0;0;0;0;0
13103;0;450;270;0;720
13104;328;1408;308;0;2044
13105;93;225;90;0;408
13106;0;0;0;0;0
13107;0;0;0;0;0
13108;0;0;0;0;0
13110;0;0;0;0;0
13111;0;0;0;0;0
13112;232;1020;450;0;1702
13114;0;0;0;0;0
13115;0;0;0;0;0
13116;0;0;44;0;44
13117;180;534;1080;0;1794
13118;392;850;412;0;1654
13119;0;0;0;0;0
13120;0;0;0;0;0
13121;107;528;132;0;767
13122;0;220;220;0;440
13123;0;35;70;0;105
13124;0;90;90;0;180
13125;0;0;0;0;0
13126;0;0;0;0;0
13128;20;72;22;0;114
13129;0;0;0;0;0
13131;0;0;0;0;0
13132;0;0;0;0;0
13133;186;470;220;0;876
13134;266;1051;118;0;1435
13135;302;962;132;0;1396
13136;0;0;0;0;0
13137;0;0;0;0;0
13138;290;120;135;0;545
13139;0;60;0;0;60
13140;0;0;0;0;0
13141;194;588;135;0;917
13142;0;0;0;0;0
13143;312;964;162;0;1438
13145;353;616;396;0;1365
13146;595;90;495;0;1180
13147;0;0;0;0;0
13148;0;0;0;0;0
13149;0;0;0;0;0
13150;0;0;0;0;0
13152;45;180;135;0;360
13153;0;0;0;0;0
13154;374;666;500;0;1540
13155;0;180;20;0;200
13156;44;831;270;0;1145
13157;81;207;175;0;463
13159;0;0;0;0;0
13160;0;0;0;0;0
13162;264;572;44;0;880
13163;751;921;220;0;1892
13164;0;0;0;0;0
13165;0;0;0;0;0
13166;0;0;0;0;0
13167;307;952;428;0;1687
13168;455;484;396;0;1335
13169;24;112;112;0;248
13170;282;880;220;0;1382
13171;0;80;75;0;155
13172;72;352;111;0;535
13173;0;0;0;0;0
13174;0;0;0;0;0
13176;44;352;176;0;572
13177;522;1452;220;0;2194
13178;0;45;180;0;225
13179;0;0;0;0;0
13180;0;0;0;0;0
13181;392;956;426;0;1774
13182;16;44;30;0;90
13183;0;0;0;0;0
13184;0;0;0;0;0
13185;396;1139;660;0;2195
13186;0;0;44;0;44
13187;77;225;45;0;347
13188;135;720;225;0;1080
13190;0;315;225;0;540
13191;130;212;123;0;465
13193;44;88;44;0;176
13194;0;0;0;0;0
13195;27;180;90;0;297
13196;0;204;45;0;249
13197;88;120;100;0;308
13198;40;247;60;0;347
13199;24;264;111;0;399
13200;0;241;155;0;396
13202;0;390;352;0;742
13203;87;225;135;0;447
13204;24;132;91;0;247
13205;205;202;225;0;632
13206;70;180;70;0;320
13207;17;90;45;0;152
13208;44;0;0;0;44
13210;0;0;0;0;0
13212;0;117;45;0;162
13214;0;159;45;0;204
13215;0;0;0;0;0
13216;78;378;275;0;731
13217;16;171;45;0;232
13218;8;0;135;0;143
13219;0;45;240;0;285
13220;71;395;225;0;691
13221;36;45;45;0;126
13300;164;449;360;0;973
13302;0;44;44;0;88
13303;0;35;115;0;150
13304;0;0;0;0;0
13305;170;74;261;0;505
13309;43;0;44;0;87
13310;0;0;0;0;0
13311;0;0;0;0;0
13312;0;0;0;0;0
13313;605;1106;225;0;1936
13314;409;561;438;0;1408
13315;0;0;0;0;0
13316;0;0;0;0;0
13319;0;0;0;0;0
13320;40;0;0;0;40
13321;0;0;0;0;0
13322;0;0;0;0;0
13324;164;764;200;0;1128
13325;0;0;0;0;0
13328;0;0;0;0;0
13329;0;0;0;0;0
13330;137;75;127;0;339
13331;8;120;30;0;158
13332;55;90;70;0;215
13333;165;143;225;0;533
13334;0;0;0;0;0
13335;0;0;0;0;0
13336;0;0;0;0;0
13338;0;0;0;0;0
13339;0;0;0;0;0
13341;153;125;90;0;368
13342;64;44;80;0;188
13343;0;0;0;0;0
13344;404;928;315;0;1647
13347;0;0;0;0;0
13350;18;60;146;0;224
13351;0;0;0;0;0
13352;264;528;176;0;968
13353;0;0;0;0;0
13356;125;450;490;0;1065
13357;0;0;0;0;0
13358;44;172;176;0;392
13359;0;0;0;0;0
13360;186;309;225;0;720
13361;174;950;315;0;1439
13362;3;0;0;0;3
13363;7;30;22;0;59
13364;0;0;0;0;0
13365;11;0;0;0;11
13366;0;0;0;0;0
13367;0;0;0;0;0
13369;0;0;0;0;0
13370;90;136;225;0;451
13372;100;373;365;0;838
13373;223;504;285;0;1012
13374;0;0;0;0;0
13375;0;40;20;0;60
13376;312;1135;450;0;1897
13377;0;0;0;0;0
13378;12;0;0;0;12
13379;0;0;44;0;44
13380;0;0;22;0;22
13381;0;0;0;0;0
13382;0;0;0;0;0
13383;97;596;419;0;1112
13384;194;1377;226;0;1797
13386;0;0;0;0;0
13387;170;1492;792;0;2454
13388;138;692;270;0;1100
13389;0;115;0;0;115
13390;0;0;0;0;0
13391;0;0;0;0;0
13392;0;0;0;0;0
13393;87;0;44;0;131
13394;225;220;90;0;535
13395;44;240;44;0;328
13396;220;958;345;0;1523
13397;0;0;0;0;0
13398;0;140;35;0;175
13400;0;0;0;0;0
13401;0;0;0;0;0
13402;0;0;0;0;0
13403;0;73;45;0;118
13405;0;45;0;0;45
13406;0;0;0;0;0
13407;0;0;0;0;0
13408;0;0;0;0;0
13409;0;0;0;0;0
13410;0;0;0;0;0
13411;0;0;0;0;0
13412;103;126;22;0;251
13413;0;0;0;0;0
13414;0;0;0;0;0
13415;30;65;28;0;123
13416;51;192;345;0;588
13417;60;187;150;0;397
13419;0;0;0;0;0
13420;965;811;681;0;2457
13422;0;0;0;0;0
13423;29;110;0;0;139
13424;0;0;110;0;110
13425;0;0;0;0;0
13426;45;60;45;0;150
13427;61;135;428;0;624
13428;136;88;264;0;488
13429;0;0;0;0;0
13430;0;0;0;0;0
13431;0;0;0;0;0
13432;0;0;0;0;0
13433;0;0;0;0;0
13434;379;695;630;0;1704
13436;0;0;0;0;0
13437;0;44;123;0;167
13438;0;0;0;0;0
13439;0;539;270;0;809
13440;0;0;0;0;0
13441;0;0;0;0;0
13442;628;540;450;0;1618
13443;0;0;0;0;0
13444;0;0;0;0;0
13445;32;187;40;0;259
13446;333;694;315;0;1342
13447;0;0;0;0;0
13448;0;0;0;0;0
13450;142;653;311;0;1106
13451;8;45;10;0;63
13453;0;0;0;0;0
13454;0;0;0;0;0
13455;197;176;32;0;405
13456;0;0;0;0;0
13457;0;96;45;0;141
13458;0;0;0;0;0
13459;0;0;0;0;0
13460;0;25;0;0;25
13461;88;440;384;0;912
13462;456;692;220;0;1368
13463;283;1200;264;0;1747
13464;0;0;0;0;0
13465;0;0;58;0;58
13467;196;372;103;0;671
13468;0;0;0;0;0
13469;12;176;0;0;188
13470;0;0;0;0;0
13471;30;197;30;0;257
13472;0;0;0;0;0
13473;78;360;45;0;483
13474;57;989;90;0;1136
13475;253;748;589;0;1590
13476;0;0;0;0;0
13477;0;0;0;0;0
13478;0;0;0;0;0
13479;98;519;135;0;752
13480;46;180;45;0;271
13481;30;110;40;0;180
13482;0;189;172;0;361
13484;40;260;0;0;300
13485;0;0;0;0;0
13486;328;927;405;0;1660
13487;0;0;0;0;0
13488;0;0;0;0;0
13489;406;450;348;0;1204
13490;0;0;0;0;0
13491;560;972;315;0;1847
13492;0;0;0;0;0
13493;210;45;90;0;345
13494;263;601;132;0;996
13495;0;0;0;0;0
13496;0;0;0;0;0
13498;0;0;0;0;0
13499;90;90;509;0;689
13500;10;0;89;0;99
13501;0;73;0;0;73
13503;40;174;135;0;349
13504;202;480;0;0;682
13505;45;270;45;0;360
13506;165;585;90;0;840
13507;0;0;0;0;0
13508;0;0;0;0;0
13509;0;0;0;0;0
13510;34;113;45;0;192
13511;0;0;0;0;0
13512;148;384;264;0;796
13513;459;180;270;0;909
13514;30;381;74;0;485
13515;42;260;90;0;392
13517;48;345;45;0;438
13518;0;204;90;0;294
13519;0;0;0;0;0
13520;0;0;0;0;0
13521;0;0;0;0;0
13522;0;0;0;0;0
13523;0;0;0;0;0
13524;20;160;45;0;225
13525;44;44;30;0;118
13526;0;0;0;0;0
13527;0;0;0;0;0
13528;59;0;0;0;59
13529;0;89;0;0;89
13530;34;90;270;0;394
13531;54;90;150;0;294
13532;69;0;65;0;134
13534;70;45;135;0;250
13535;89;340;180;0;609
13536;16;45;45;0;106
13537;0;0;0;0;0
13538;0;271;44;0;315
13539;206;459;300;0;965
13540;17;45;270;0;332
13541;40;180;45;0;265
13542;141;900;180;0;1221
13543;107;270;45;0;422
13544;0;67;22;0;89
13545;82;320;180;0;582
13546;0;0;0;0;0
13548;0;0;0;0;0
13549;0;0;0;0;0
13551;104;435;176;0;715
13552;75;128;90;0;293
13553;68;45;0;0;113
13554;56;30;30;0;116
13555;0;0;0;0;0
13556;0;0;0;0;0
13557;164;602;88;0;854
13558;206;616;308;0;1130
13559;239;462;88;0;789
13560;195;748;264;0;1207
13561;273;752;308;0;1333
13562;186;500;264;0;950
13563;142;478;88;0;708
13565;357;570;210;0;1137
13566;110;269;45;0;424
13567;92;135;90;0;317
13568;69;0;135;0;204
13569;19;129;90;0;238
13570;0;94;30;0;124
13571;0;0;0;0;0
13572;0;90;0;0;90
13573;0;450;360;0;810
13574;44;134;90;0;268
13575;45;342;340;0;727
13576;119;352;220;0;691
13577;16;90;0;0;106
13579;0;32;0;0;32
13580;105;143;133;0;381
13582;0;243;192;0;435
13583;0;0;0;0;0
13584;74;149;60;0;283
13585;0;0;0;0;0
13586;282;1203;360;0;1845
13587;115;336;45;0;496
13588;0;0;0;0;0
13589;0;90;0;0;90
13590;188;924;485;0;1597
13591;183;625;222;0;1030
13592;0;45;0;0;45
13593;199;558;166;0;923
13594;0;0;0;0;0
13596;0;0;0;0;0
13597;30;206;50;0;286
13598;45;315;0;0;360
13599;0;86;44;0;130
13601;32;45;270;0;347
13602;85;75;340;0;500
13603;0;0;0;0;0
13604;238;405;180;0;823
13605;0;0;0;0;0
13606;385;769;567;0;1721
13607;58;270;164;0;492
13608;64;95;256;0;415
13609;49;363;90;0;502
13610;64;209;180;0;453
13611;44;91;0;0;135
13612;89;280;280;0;649
13613;65;45;74;0;184
13615;0;0;0;0;0
13616;0;0;0;0;0
13617;0;0;0;0;0
13618;0;0;0;0;0
13619;0;0;0;0;0
13620;0;44;0;0;44
13621;137;225;135;0;497
13622;0;0;0;0;0
13623;24;130;45;0;199
13624;0;0;0;0;0
13625;24;132;88;0;244
13626;221;247;0;0;468
13627;224;449;400;0;1073
13629;40;0;20;0;60
13630;113;315;0;0;428
13632;161;578;315;0;1054
13633;0;303;90;0;393
13634;0;0;0;0;0
13635;0;0;0;0;0
13636;32;132;44;0;208
13637;36;322;45;0;403
14000;0;0;0;0;0
14201;161;1170;180;0;1511
14202;165;269;135;0;569
14203;0;0;0;0;0
14205;0;0;0;0;0
14206;97;132;176;0;405
14208;166;176;264;0;606
14209;84;257;133;0;474
14210;189;413;945;0;1547
14211;89;999;0;0;1088
14212;46;380;175;0;601
14213;187;552;220;0;959
14215;38;405;315;0;758
14216;0;0;0;0;0
14217;0;531;450;0;981
14218;0;0;0;0;0
14219;0;0;0;0;0
14220;0;0;0;0;0
14221;0;0;0;0;0
14222;0;0;0;0;0
14223;0;0;0;0;0
14224;0;0;0;0;0
14225;0;90;45;0;135
14226;0;0;0;0;0
14227;0;0;0;0;0
14229;0;0;0;0;0
14230;0;0;0;0;0
14232;136;377;375;0;888
14233;42;303;255;0;600
14234;45;45;45;0;135
14235;0;0;0;0;0
14237;76;549;135;0;760
14238;0;0;0;0;0
14239;0;0;0;0;0
14240;0;0;0;0;0
14243;0;0;0;0;0
14244;0;0;0;0;0
14246;0;0;0;0;0
14247;0;44;0;0;44
14249;0;0;0;0;0
14250;0;0;0;0;0
14251;0;0;0;0;0
14253;0;0;0;0;0
14254;0;0;0;0;0
14255;0;0;0;0;0
14256;0;0;0;0;0
14257;0;0;0;0;0
14258;0;0;0;0;0
14260;40;30;81;0;151
14261;0;0;0;0;0
14263;0;0;0;0;0
14264;0;0;0;0;0
14265;0;189;45;0;234
14266;85;313;150;0;548
14267;0;0;0;0;0
14268;0;90;20;0;110
14269;0;0;0;0;0
14270;65;616;45;0;726
14271;91;280;132;0;503
14273;0;0;0;0;0
14274;0;0;0;0;0
14275;0;0;0;0;0
14278;0;0;0;0;0
14279;0;0;0;0;0
14280;33;0;0;0;33
14281;0;0;0;0;0
14282;0;0;0;0;0
14283;28;90;45;0;163
14284;210;225;90;0;525
14285;0;0;0;0;0
14286;0;0;0;0;0
14287;0;0;0;0;0
14288;12;366;225;0;603
14289;64;686;45;0;795
14290;0;0;0;0;0
14291;0;0;0;0;0
14292;0;0;0;0;0
14294;0;0;0;0;0
14296;0;0;0;0;0
14297;0;0;0;0;0
14298;0;0;0;0;0
14299;227;435;212;0;874
14300;110;88;234;0;432
14301;0;0;0;0;0
14303;0;0;0;0;0
14304;0;0;0;0;0
14305;59;473;45;0;577
14306;0;0;0;0;0
14307;40;0;23;0;63
14308;125;314;135;0;574
14310;41;276;90;0;407
14313;40;551;359;0;950
14314;18;178;216;0;412
14315;75;225;225;0;525
14316;90;405;340;0;835
14317;0;0;0;0;0
14318;0;0;0;0;0
14319;0;0;0;0;0
14320;0;0;0;0;0
14321;0;0;0;0;0
14322;10;76;20;0;106
14323;79;189;35;0;303
14324;0;0;0;0;0
14325;0;0;0;0;0
14327;0;0;0;0;0
14328;0;0;0;0;0
14329;0;0;0;0;0
14330;78;83;0;0;161
14331;0;0;0;0;0
14332;0;122;70;0;192
14334;0;0;0;0;0
14335;0;0;0;0;0
14336;90;195;90;0;375
14337;0;0;0;0;0
14338;0;0;0;0;0
14339;0;0;0;0;0
14340;0;0;0;0;0
14341;0;0;0;0;0
14342;0;0;0;0;0
14344;0;0;0;0;0
14345;0;0;0;0;0
14346;0;0;0;0;0
14347;111;106;44;0;261
14348;405;980;815;0;2200
14349;0;0;0;0;0
14351;64;286;146;0;496
14352;0;0;0;0;0
14353;0;0;0;0;0
14354;0;0;135;0;135
14355;0;0;0;0;0
14356;0;0;0;0;0
14358;0;0;0;0;0
14359;261;1304;720;0;2285
14361;0;0;0;0;0
14362;21;45;45;0;111
14363;115;1400;725;0;2240
14364;54;111;159;0;324
14365;0;225;90;0;315
14366;0;0;0;0;0
14367;0;0;0;0;0
14370;0;0;0;0;0
14371;0;90;0;0;90
14372;53;402;125;0;580
14373;75;355;270;0;700
14375;69;765;180;0;1014
14376;25;402;176;0;603
14377;0;0;0;0;0
14379;90;0;0;0;90
14380;0;42;42;0;84
14381;28;627;270;0;925
14382;0;0;0;0;0
14383;0;0;0;0;0
14384;0;0;0;0;0
14385;0;0;0;0;0
14386;110;10;23;0;143
14387;196;427;250;0;873
14389;131;224;205;0;560
14392;51;157;165;0;373
14393;0;0;0;0;0
14394;0;20;0;0;20
14395;31;788;135;0;954
14396;65;30;85;0;180
14397;139;575;90;0;804
14398;48;177;40;0;265
14400;74;251;399;0;724
14401;0;0;0;0;0
14402;0;0;0;0;0
14403;0;0;0;0;0
14404;0;0;0;0;0
14405;0;0;0;0;0
14408;0;0;0;0;0
14409;0;0;0;0;0
14411;0;100;25;0;125
14412;0;135;97;0;232
14413;139;196;538;0;873
14414;45;787;135;0;967
14415;0;0;0;0;0
14416;71;694;315;0;1080
14417;0;30;45;0;75
14418;110;305;116;0;531
14419;0;0;0;0;0
14420;12;182;67;0;261
14421;45;9;103;0;157
14422;0;0;0;0;0
14423;0;180;45;0;225
14425;0;0;0;0;0
14426;0;0;0;0;0
14427;0;0;0;0;0
14428;0;0;0;0;0
14430;0;0;0;0;0
14431;0;0;0;0;0
14432;0;0;0;0;0
14433;0;0;0;0;0
14434;0;0;0;0;0
14435;0;0;0;0;0
14436;0;0;0;0;0
14437;0;0;0;0;0
14439;43;0;0;0;43
14440;52;33;45;0;130
14442;0;0;0;0;0
14443;0;0;0;0;0
14444;0;0;0;0;0
14445;0;0;0;0;0
14446;0;115;45;0;160
14447;0;0;0;0;0
14448;0;0;0;0;0
14449;0;0;0;0;0
14450;0;0;0;0;0
14451;0;0;0;0;0
14452;16;137;118;0;271
14453;274;0;165;0;439
14454;0;300;184;0;484
14456;0;0;0;0;0
14457;44;176;44;0;264
14458;0;0;0;0;0
14459;0;0;0;0;0
14460;0;115;140;0;255
14461;0;0;0;0;0
14462;0;44;70;0;114
14463;48;340;90;0;478
14465;0;0;0;0;0
14466;0;0;0;0;0
14467;0;117;45;0;162
14468;0;0;0;0;0
14470;93;220;132;0;445
14471;0;0;0;0;0
14473;0;0;0;0;0
14474;0;0;0;0;0
14475;0;0;0;0;0
14476;491;524;450;0;1465
14478;0;0;0;0;0
14479;149;830;338;0;1317
14480;0;0;0;0;0
14481;0;0;0;0;0
14482;40;246;45;0;331
14483;0;0;0;0;0
14484;0;0;0;0;0
14485;0;0;0;0;0
14487;285;384;209;0;878
14488;0;0;0;0;0
14489;0;0;0;0;0
14490;335;562;484;0;1381
14491;0;0;0;0;0
14492;60;90;182;0;332
14493;64;199;89;0;352
14494;45;28;90;0;163
14495;0;0;0;0;0
14496;0;0;0;0;0
14497;0;0;0;0;0
14498;0;0;0;0;0
14499;0;68;70;0;138
14500;135;180;45;0;360
14501;0;0;0;0;0
14502;0;0;0;0;0
14503;0;0;0;0;0
14504;42;211;165;0;418
14506;0;1095;270;0;1365
14507;104;241;78;0;423
14508;0;0;0;0;0
14509;0;90;0;0;90
14510;186;739;45;0;970
14511;30;270;135;0;435
14512;3;0;112;0;115
14513;24;27;0;0;51
14514;329;1238;180;0;1747
14515;25;218;132;0;375
14516;0;0;0;0;0
14517;18;80;23;0;121
14518;15;32;52;0;99
14520;0;0;0;0;0
14521;5;84;0;0;89
14523;164;1689;810;0;2663
14524;0;0;0;0;0
14525;0;125;40;0;165
14526;155;652;448;0;1255
14527;16;78;45;0;139
14528;0;0;0;0;0
14529;0;0;0;0;0
14530;0;0;0;0;0
14531;105;269;44;0;418
14532;0;0;0;0;0
14533;38;345;114;0;497
14534;120;338;255;0;713
14535;0;0;0;0;0
14537;124;275;90;0;489
14538;381;318;664;0;1363
14539;142;158;160;0;460
14540;0;0;0;0;0
14541;49;495;225;0;769
14542;19;90;90;0;199
14543;28;45;90;0;163
14544;0;0;0;0;0
14545;0;165;45;0;210
14546;0;68;45;0;113
14547;23;0;23;0;46
14548;0;24;0;0;24
14549;0;0;0;0;0
14550;0;135;0;0;135
14551;9;103;52;0;164
14552;275;459;180;0;914
14554;0;0;0;0;0
14555;0;0;0;0;0
14556;45;90;45;0;180
14557;32;130;40;0;202
14558;0;0;0;0;0
14559;62;264;45;0;371
14560;0;0;0;0;0
14561;30;54;20;0;104
14562;0;0;0;0;0
14563;0;0;0;0;0
14564;0;0;0;0;0
14565;40;353;189;0;582
14566;0;0;0;0;0
14568;101;381;118;0;600
14569;16;79;45;0;140
14571;0;0;0;0;0
14572;151;77;45;0;273
14573;59;91;20;0;170
14574;0;0;0;0;0
14575;0;0;0;0;0
14576;0;0;0;0;0
14577;22;52;44;0;118
14578;42;0;135;0;177
14579;0;0;0;0;0
14580;65;180;90;0;335
14581;0;0;0;0;0
14582;0;0;0;0;0
14583;0;55;25;0;80
14585;0;0;0;0;0
14586;0;0;0;0;0
14587;38;35;90;0;163
14588;56;45;135;0;236
14589;88;152;42;0;282
14590;0;0;0;0;0
14591;0;0;0;0;0
14592;0;0;45;0;45
14593;44;88;69;0;201
14594;103;570;263;0;936
14595;0;0;0;0;0
14596;0;0;0;0;0
14597;0;0;0;0;0
14599;6;139;134;0;279
14600;0;0;0;0;0
14601;196;45;45;0;286
14602;73;278;40;0;391
14604;0;0;0;0;0
14605;123;585;270;0;978
14606;45;45;90;0;180
14607;0;0;0;0;0
14608;489;1526;495;0;2510
14609;0;75;0;0;75
14610;0;0;0;0;0
14611;0;0;0;0;0
14612;0;0;0;0;0
14613;0;0;0;0;0
14614;20;313;426;0;759
14615;0;0;0;0;0
14616;156;445;640;0;1241
14618;0;0;0;0;0
14619;0;0;0;0;0
14621;0;0;55;0;55
14622;52;180;210;0;442
14623;0;0;0;0;0
14624;0;0;0;0;0
14625;45;135;22;0;202
14626;149;45;90;0;284
14627;0;0;0;0;0
14628;0;45;45;0;90
14629;359;1231;674;0;2264
14630;0;35;0;0;35
14631;0;70;30;0;100
14632;0;0;0;0;0
14633;0;0;0;0;0
14635;0;0;0;0;0
14636;25;204;45;0;274
14637;18;334;50;0;402
14638;30;125;75;0;230
14639;77;110;55;0;242
14640;0;0;0;0;0
14641;70;120;135;0;325
14642;232;414;315;0;961
14643;90;180;180;0;450
14644;0;0;0;0;0
14645;5;50;0;0;55
14646;0;0;0;0;0
14647;0;0;0;0;0
14649;73;258;65;0;396
14650;45;347;70;0;462
14652;0;0;0;0;0
14653;0;0;0;0;0
14654;44;45;45;0;134
14655;10;10;10;0;30
14656;0;0;0;0;0
14657;0;0;0;0;0
14658;45;0;80;0;125
14659;6;45;95;0;146
14660;0;0;0;0;0
14662;75;367;85;0;527
14663;7;65;60;0;132
14664;10;92;44;0;146
14666;40;225;134;0;399
14667;0;0;0;0;0
14668;0;0;0;0;0
14669;0;166;42;0;208
14670;135;519;405;0;1059
14671;430;918;90;0;1438
14672;18;113;96;0;227
14673;141;709;278;0;1128
14674;254;454;90;0;798
14675;20;158;67;0;245
14676;0;0;0;0;0
14677;0;177;180;0;357
14678;210;332;132;0;674
14680;0;0;0;0;0
14681;3;102;75;0;180
14683;0;0;0;0;0
14684;0;0;0;0;0
14685;192;0;161;0;353
14686;69;0;153;0;222
14687;203;376;165;0;744
14688;0;0;0;0;0
14689;0;0;0;0;0
14690;5;0;112;0;117
14691;0;105;45;0;150
14692;22;90;237;0;349
14693;32;90;60;0;182
14694;0;0;0;0;0
14695;0;180;22;0;202
14697;289;1946;484;0;2719
14698;17;75;90;0;182
14699;62;503;360;0;925
14700;0;0;0;0;0
14702;0;180;90;0;270
14703;226;470;470;0;1166
14705;24;195;40;0;259
14706;150;465;155;0;770
14707;55;572;180;0;807
14708;12;234;32;0;278
14709;22;103;125;0;250
14710;0;0;0;0;0
14711;90;180;90;0;360
14712;0;0;0;0;0
14713;0;0;0;0;0
14714;0;0;0;0;0
14716;126;279;280;0;685
14717;95;521;243;0;859
14718;61;15;45;0;121
14719;19;58;85;0;162
14720;123;656;264;0;1043
14721;44;45;135;0;224
14722;0;0;0;0;0
14723;0;0;65;0;65
14724;0;0;0;0;0
14725;0;0;0;0;0
14726;20;52;141;0;213
14727;25;0;0;0;25
14728;0;0;0;0;0
14730;21;225;0;0;246
14731;16;143;45;0;204
14733;21;230;0;0;251
14734;0;0;0;0;0
14735;0;120;25;0;145
14736;6;45;0;0;51
14737;27;336;136;0;499
14738;0;60;0;0;60
14739;14;0;90;0;104
14740;0;0;0;0;0
14741;0;0;0;0;0
14742;32;45;135;0;212
14743;0;0;0;0;0
14744;0;0;0;0;0
14745;0;0;0;0;0
14747;0;90;135;0;225
14748;0;6;0;0;6
14749;0;0;0;0;0
14750;131;90;180;0;401
14751;224;405;180;0;809
14752;0;0;0;0;0
14753;44;394;160;0;598
14754;0;45;0;0;45
14755;9;0;45;0;54
14756;0;0;0;0;0
14757;0;0;0;0;0
14758;0;0;0;0;0
14759;129;45;35;0;209
14760;44;321;410;0;775
14761;45;0;65;0;110
14762;250;152;229;0;631
14764;135;629;315;0;1079
14765;23;113;82;0;218
14766;14;0;126;0;140
14767;26;135;10;0;171
14768;0;0;0;0;0
14769;34;0;183;0;217
14770;425;720;360;0;1505
14771;220;153;45;0;418
14772;0;0;0;0;0
14773;50;600;630;0;1280
14774;40;112;45;0;197
14775;67;532;259;0;858
14776;0;0;0;0;0
14778;215;412;202;0;829
14779;180;125;135;0;440
14781;54;36;45;0;135
14782;48;45;360;0;453
14783;184;755;675;0;1614
14784;0;0;0;0;0
14785;11;82;44;0;137
14786;0;0;0;0;0
14787;34;270;22;0;326
14788;118;451;225;0;794
14789;0;77;90;0;167
14790;230;673;373;0;1276
14791;0;55;0;0;55
14792;0;90;45;0;135
14793;53;72;45;0;170
14795;0;0;0;0;0
14796;25;0;21;0;46
14797;0;0;0;0;0
14798;21;162;45;0;228
14799;285;314;0;0;599
14800;122;315;45;0;482
14801;130;255;180;0;565
14802;25;240;97;0;362
14803;36;0;177;0;213
14804;42;540;135;0;717
14805;149;390;132;0;671
14806;0;93;0;0;93
14807;0;0;0;0;0
14808;45;45;10;0;100
14809;19;45;176;0;240
14810;16;112;0;0;128
14811;34;180;45;0;259
14812;0;0;0;0;0
14814;0;0;0;0;0
14815;0;0;0;0;0
14816;0;0;0;0;0
14817;0;0;0;0;0
14818;30;630;180;0;840
14819;176;121;222;0;519
14820;239;495;135;0;869
14821;0;0;0;0;0
14822;107;495;0;0;602
14823;170;208;120;0;498
14824;91;329;480;0;900
14825;270;457;320;0;1047
14826;0;0;0;0;0
14828;25;127;45;0;197
14829;97;362;40;0;499
14831;0;0;0;0;0
14832;29;45;255;0;329
14833;9;248;45;0;302
14834;0;0;0;0;0
14835;0;0;0;0;0
14836;33;118;45;0;196
14837;0;73;40;0;113
14838;0;20;0;0;20
14839;8;180;0;0;188
14840;0;0;0;0;0
14841;0;0;0;0;0
14842;0;0;0;0;0
14843;0;0;0;0;0
14845;90;135;68;0;293
14846;0;90;24;0;114
14847;0;0;75;0;75
14848;40;56;270;0;366
14850;71;120;0;0;191
14851;30;135;0;0;165
14852;0;51;125;0;176
14853;0;0;0;0;0
14854;34;157;15;0;206
14855;0;0;0;0;0
14856;110;455;540;0;1105
14857;0;0;0;0;0
14859;44;0;270;0;314
14860;68;193;343;0;604
14862;99;261;180;0;540
14863;42;0;174;0;216
14864;8;45;46;0;99
14865;137;352;45;0;534
14866;33;1004;290;0;1327
14867;0;0;0;0;0
14868;66;90;90;0;246
14869;0;0;0;0;0
14870;11;435;180;0;626
14871;45;45;113;0;203
14872;20;153;45;0;218
14873;0;5;67;0;72
14874;10;72;30;0;112
14876;44;80;100;0;224
14877;60;220;157;0;437
14878;26;90;0;0;116
14879;751;2250;810;0;3811
14880;94;225;157;0;476
14881;216;382;299;0;897
14882;13;90;65;0;168
14883;21;225;90;0;336
14884;0;0;0;0;0
14885;60;83;170;0;313
14886;45;0;0;0;45
14887;34;180;90;0;304
14888;0;0;0;0;0
14890;67;52;67;0;186
14891;0;45;0;0;45
14893;0;0;0;0;0
14894;9;38;110;0;157
14895;0;45;0;0;45
14896;0;45;90;0;135
14897;58;68;225;0;351
14898;0;0;0;0;0
14899;0;0;0;0;0
14900;0;0;0;0;0
14901;115;921;196;0;1232
14902;180;135;225;0;540
14903;34;135;40;0;209
14904;0;81;117;0;198
14905;0;0;0;0;0
14906;0;0;0;0;0
14907;32;0;355;0;387
14909;24;270;45;0;339
14910;0;0;103;0;103
14912;336;613;180;0;1129
14913;90;247;135;0;472
14914;0;0;0;0;0
14915;10;45;45;0;100
14916;0;135;45;0;180
14917;196;172;132;0;500
14918;45;90;0;0;135
14919;0;0;0;0;0
14920;47;30;45;0;122
14921;0;60;0;0;60
14922;265;226;419;0;910
14923;206;437;296;0;939
14924;24;132;44;0;200
14926;22;69;270;0;361
14927;22;158;45;0;225
14928;46;0;202;0;248
14929;200;55;153;0;408
14930;28;133;160;0;321
14931;0;40;360;0;400
14932;17;162;45;0;224
14933;43;153;157;0;353
14934;33;225;90;0;348
14935;25;132;124;0;281
14936;0;0;0;0;0
14937;26;98;45;0;169
14938;154;0;45;0;199
14940;0;0;0;0;0
14941;38;138;33;0;209
14943;46;0;225;0;271
14944;52;180;90;0;322
14945;51;9;65;0;125
14946;0;0;0;0;0
14947;32;165;87;0;284
14948;0;0;0;0;0
14949;156;88;88;0;332
14950;11;79;38;0;128
14951;0;110;90;0;200
14952;90;264;213;0;567
14953;120;434;290;0;844
14954;120;180;45;0;345
14955;82;269;45;0;396
15500;0;0;0;0;0
15501;116;308;135;0;559
15502;0;195;0;0;195
15503;84;308;132;0;524
15504;0;0;0;0;0
15505;0;0;0;0;0
15506;0;0;0;0;0
15507;0;0;0;0;0
15510;0;0;0;0;0
15512;0;0;0;0;0
15513;0;0;0;0;0
15514;0;0;0;0;0
15515;61;467;160;0;688
15516;0;0;0;0;0
15517;0;0;0;0;0
15518;0;0;0;0;0
15520;0;0;0;0;0
15521;0;0;0;0;0
15522;51;75;110;0;236
15523;0;0;0;0;0
15524;0;91;0;0;91
15526;113;915;226;0;1254
15527;0;0;0;0;0
15528;0;0;0;0;0
15529;0;0;0;0;0
15530;0;0;0;0;0
15531;0;120;75;0;195
15532;0;0;0;0;0
15533;0;0;0;0;0
15534;60;450;170;0;680
15535;158;264;162;0;584
15536;0;0;0;0;0
15537;0;0;0;0;0
15538;0;0;0;0;0
15540;0;0;0;0;0
15544;104;282;198;0;584
15545;0;0;0;0;0
15546;0;0;0;0;0
15547;0;0;0;0;0
15548;0;0;0;0;0
15549;0;0;0;0;0
15550;0;0;0;0;0
15551;89;243;70;0;402
15552;0;0;0;0;0
15553;0;0;0;0;0
15554;105;396;143;0;644
15555;0;0;0;0;0
15557;63;324;45;0;432
15558;0;0;0;0;0
15559;0;0;0;0;0
15560;0;0;0;0;0
15561;0;0;0;0;0
15563;0;0;0;0;0
15564;187;625;134;0;946
15565;0;0;0;0;0
15566;0;0;0;0;0
15567;0;0;0;0;0
15568;0;0;0;0;0
15569;10;0;0;0;10
15570;203;632;132;0;967
15571;300;315;240;0;855
15572;0;0;0;0;0
15574;14;88;44;0;146
15575;0;0;0;0;0
15576;80;451;263;0;794
15577;0;0;0;0;0
15578;0;0;0;0;0
15579;45;333;72;0;450
15580;0;0;0;0;0
15581;0;0;0;0;0
15582;42;177;45;0;264
15583;91;517;658;0;1266
15584;0;0;0;0;0
15585;0;522;75;0;597
15586;78;180;94;0;352
15588;83;200;40;0;323
15589;45;150;90;0;285
15591;0;0;0;0;0
15592;0;0;0;0;0
15593;338;370;110;0;818
15594;151;481;110;0;742
15595;45;180;135;0;360
15596;150;718;514;0;1382
15597;0;0;0;0;0
15598;0;0;88;0;88
15599;0;0;0;0;0
15600;164;396;170;0;730
15601;63;962;0;0;1025
15602;0;0;0;0;0
15603;0;0;0;0;0
15604;0;0;0;0;0
15605;68;90;156;0;314
15607;62;140;90;0;292
15608;87;546;265;0;898
15609;0;0;0;0;0
15610;120;470;188;0;778
15611;0;0;0;0;0
15612;0;0;0;0;0
15613;0;0;0;0;0
15614;397;1303;308;0;2008
15615;0;0;10;0;10
15616;0;0;0;0;0
15617;0;0;0;0;0
15619;0;0;0;0;0
15621;136;486;135;0;757
15622;116;264;132;0;512
15624;405;1176;613;0;2194
15625;0;0;0;0;0
15626;0;0;0;0;0
15627;56;570;288;0;914
15628;0;0;40;0;40
15629;16;44;0;0;60
15630;0;0;0;0;0
15631;0;0;81;0;81
15632;108;545;135;0;788
15633;224;382;227;0;833
15634;0;0;0;0;0
15635;0;0;0;0;0
15636;0;0;0;0;0
15638;0;0;0;0;0
15639;0;0;0;0;0
15641;57;145;40;0;242
15642;0;0;0;0;0
15643;55;252;180;0;487
15644;20;125;109;0;254
15645;0;0;0;0;0
15646;1872;3434;180;0;5486
15647;0;0;0;0;0
15648;0;0;0;0;0
15649;0;0;0;0;0
15650;147;180;45;0;372
15652;0;0;0;0;0
15653;32;180;90;0;302
15655;0;0;0;0;0
15656;25;92;45;0;162
15657;195;225;270;0;690
15658;0;50;66;0;116
15659;0;0;0;0;0
15660;68;165;35;0;268
15661;10;106;0;0;116
15662;297;992;258;0;1547
15663;259;45;120;0;424
15664;856;1568;893;0;3317
15665;91;211;88;0;390
15666;0;0;0;0;0
15667;0;0;0;0;0
15669;0;0;0;0;0
15670;0;0;0;0;0
15671;0;0;0;0;0
15672;72;450;60;0;582
15673;67;197;45;0;309
15674;0;0;0;0;0
15675;49;270;45;0;364
15676;40;220;595;0;855
15677;20;45;20;0;85
15678;0;0;0;0;0
15679;0;0;0;0;0
15680;0;0;0;0;0
15681;20;65;35;0;120
15682;13;125;0;0;138
15683;132;743;308;0;1183
15684;158;454;135;0;747
15686;0;0;0;0;0
15687;39;264;0;0;303
15688;0;0;0;0;0
15689;0;0;0;0;0
15690;474;480;832;0;1786
15691;16;168;55;0;239
15692;0;0;0;0;0
15694;0;89;0;0;89
15695;0;25;0;0;25
15696;0;45;216;0;261
15697;0;0;0;0;0
15698;16;45;135;0;196
15700;90;626;225;0;941
15701;0;0;0;0;0
15702;0;0;0;0;0
15703;0;0;0;0;0
15705;68;201;152;0;421
15706;20;135;28;0;183
15707;65;87;44;0;196
15708;83;197;0;0;280
15709;0;0;0;0;0
15710;0;0;0;0;0
15711;45;42;45;0;132
15712;41;217;45;0;303
15713;0;186;0;0;186
15714;45;225;90;0;360
15715;44;0;130;0;174
15716;151;225;67;0;443
15717;42;90;180;0;312
15719;47;215;45;0;307
15720;110;352;162;0;624
15722;93;90;45;0;228
15723;12;43;85;0;140
15724;241;882;264;0;1387
15725;0;0;0;0;0
15726;372;738;495;0;1605
15727;0;0;0;0;0
15728;88;384;181;0;653
15729;81;270;45;0;396
15730;0;0;0;0;0
15731;161;240;120;0;521
15732;138;600;90;0;828
15733;0;0;0;0;0
15734;39;24;24;0;87
15736;54;114;45;0;213
15737;0;0;0;0;0
15738;81;180;30;0;291
15739;132;994;296;0;1422
15740;22;110;45;0;177
15741;19;0;135;0;154
15742;27;195;45;0;267
15743;0;0;0;0;0
15744;59;668;180;0;907
15745;401;884;315;0;1600
15746;23;185;45;0;253
15747;0;0;158;0;158
15748;102;412;44;0;558
15750;304;557;234;0;1095
15751;35;195;20;0;250
15753;153;341;259;0;753
15754;52;264;82;0;398
15755;167;265;155;0;587
15756;90;45;45;0;180
15757;223;267;225;0;715
15758;20;135;200;0;355
15759;155;528;294;0;977
15760;19;100;0;0;119
15761;56;210;90;0;356
15762;176;478;132;0;786
15763;22;14;15;0;51
15764;45;252;45;0;342
15765;27;127;71;0;225
15767;150;498;153;0;801
15768;146;388;222;0;756
15769;149;272;284;0;705
15770;223;1505;566;0;2294
15771;0;0;0;0;0
15772;0;0;0;0;0
15773;0;0;0;0;0
15774;108;315;225;0;648
15775;160;135;240;0;535
15776;402;263;90;0;755
15777;86;135;0;0;221
15778;25;42;116;0;183
15779;223;181;141;0;545
15780;100;235;44;0;379
15781;144;538;250;0;932
15782;110;88;68;0;266
15784;59;112;69;0;240
15785;69;165;45;0;279
15786;0;68;72;0;140
15787;225;945;90;0;1260
15788;12;53;46;0;111
15789;19;160;45;0;224
15790;541;646;680;0;1867
15791;46;52;90;0;188
15792;129;134;322;0;585
15793;254;677;200;0;1131
15794;0;0;0;0;0
15795;30;40;20;0;90
15796;46;120;90;0;256
15798;16;105;25;0;146
15799;32;180;45;0;257
15800;74;170;51;0;295
15801;0;45;9;0;54
15803;0;35;0;0;35
15804;40;178;90;0;308
15805;61;180;152;0;393
15806;21;50;70;0;141
15807;58;601;90;0;749
15808;49;628;220;0;897
15809;0;404;135;0;539
15810;0;0;0;0;0
15811;185;105;90;0;380
15812;198;1092;308;0;1598
15813;0;0;0;0;0
15814;0;20;22;0;42
15815;46;199;179;0;424
15817;76;623;269;0;968
15818;16;90;45;0;151
15819;28;90;45;0;163
15820;45;405;180;0;630
15821;16;44;132;0;192
15822;12;44;0;0;56
15823;65;0;225;0;290
15824;0;0;0;0;0
15825;69;0;180;0;249
15826;122;225;45;0;392
15827;0;50;45;0;95
15828;282;444;160;0;886
15829;16;110;20;0;146
15830;10;55;135;0;200
15831;0;45;0;0;45
15832;10;165;175;0;350
15834;52;151;30;0;233
15835;45;342;44;0;431
15836;0;53;0;0;53
15837;0;0;0;0;0
15838;153;0;90;0;243
15839;8;205;25;0;238
15840;56;90;73;0;219
15841;41;270;67;0;378
15842;0;132;0;0;132
15843;112;752;440;0;1304
15844;0;260;44;0;304
15845;44;168;120;0;332
15846;50;90;92;0;232
15848;1;0;90;0;91
15849;88;0;45;0;133
15851;118;0;147;0;265
15852;30;45;45;0;120
15853;0;295;45;0;340
15854;20;20;20;0;60
15855;45;80;90;0;215
15856;52;158;25;0;235
15857;50;45;45;0;140
15858;143;45;45;0;233
15859;99;188;58;0;345
16389;0;0;0;0;0
16400;0;0;0;0;0
16401;0;0;0;0;0
16403;0;0;0;0;0
16405;0;0;0;0;0
16406;12;127;44;0;183
16408;0;0;0;0;0
16409;0;0;0;0;0
16410;345;809;270;0;1424
16411;0;0;0;0;0
16413;0;0;0;0;0
16414;0;45;45;0;90
16415;322;1108;630;0;2060
16417;155;661;478;0;1294
16418;0;0;0;0;0
16419;0;0;0;0;0
16420;0;0;0;0;0
16421;0;0;0;0;0
16422;0;0;0;0;0
16423;0;0;0;0;0
16424;110;264;132;0;506
16425;0;0;0;0;0
16427;253;456;360;0;1069
16428;434;904;308;0;1646
16429;23;376;45;0;444
16430;0;0;0;0;0
16431;150;583;225;0;958
16432;110;405;247;0;762
16434;237;45;285;0;567
16436;0;0;0;0;0
16437;0;0;0;0;0
16441;209;822;765;0;1796
16442;0;0;0;0;0
16443;45;405;325;0;775
16444;309;953;315;0;1577
16445;0;0;0;0;0
16446;125;1542;694;0;2361
16447;0;0;0;0;0
16448;98;940;953;0;1991
16449;4;0;75;0;79
16451;0;0;0;0;0
16452;358;501;533;0;1392
16453;0;0;234;0;234
16454;0;6;0;0;6
16455;74;290;88;0;452
16456;175;118;135;0;428
16457;45;45;68;0;158
16458;0;0;0;0;0
16459;88;450;225;0;763
16460;276;814;398;0;1488
16461;28;189;69;0;286
16462;0;45;90;0;135
16463;0;0;0;0;0
16465;0;0;0;0;0
16466;12;45;36;0;93
16467;132;315;180;0;627
16468;672;2434;264;0;3370
16469;376;1152;530;0;2058
16470;133;489;686;0;1308
16471;3;0;70;0;73
16472;20;40;112;0;172
16473;0;0;0;0;0
16474;0;0;0;0;0
16475;0;0;0;0;0
16476;60;368;135;0;563
16477;45;123;180;0;348
16479;23;334;171;0;528
16480;0;0;0;0;0
16482;0;0;0;0;0
16483;0;0;0;0;0
16484;302;205;344;0;851
16485;95;548;180;0;823
16486;0;0;0;0;0
16487;0;0;0;0;0
16488;114;499;135;0;748
16489;15;195;295;0;505
16490;12;45;203;0;260
16491;59;323;165;0;547
16492;80;0;553;0;633
16493;0;0;0;0;0
16494;102;761;384;0;1247
16496;0;0;0;0;0
16497;61;462;135;0;658
16498;0;0;0;0;0
16499;0;180;0;0;180
16501;0;338;0;0;338
16502;76;114;170;0;360
16503;0;0;0;0;0
16504;0;130;45;0;175
16506;312;1088;352;0;1752
16507;90;635;143;0;868
16508;302;460;385;0;1147
16509;20;379;157;0;556
16510;25;88;44;0;157
16511;0;0;0;0;0
16512;260;555;230;0;1045
16513;136;210;101;0;447
16515;0;0;0;0;0
16516;0;0;0;0;0
16517;0;0;0;0;0
16518;48;158;85;0;291
16519;0;0;0;0;0
16520;142;324;195;0;661
16521;0;212;45;0;257
16522;0;0;0;0;0
16523;27;135;90;0;252
16524;0;0;0;0;0
16525;0;0;0;0;0
16526;140;450;135;0;725
16527;0;0;0;0;0
16529;0;0;0;0;0
16530;59;289;45;0;393
16532;0;0;0;0;0
16533;25;225;45;0;295
16534;0;117;20;0;137
16535;467;585;389;0;1441
16536;45;225;35;0;305
16537;146;135;45;0;326
16538;0;0;0;0;0
16539;0;0;0;0;0
16540;0;0;0;0;0
16541;145;312;220;0;677
16542;24;0;180;0;204
16543;7;30;0;0;37
16544;32;15;149;0;196
16546;0;23;40;0;63
16547;0;0;0;0;0
16548;45;316;45;0;406
16549;128;449;135;0;712
16550;294;775;225;0;1294
16551;116;221;135;0;472
16552;16;45;65;0;126
16553;117;180;45;0;342
16554;64;315;90;0;469
16555;0;0;0;0;0
16556;98;530;81;0;709
16557;35;208;45;0;288
16558;86;213;225;0;524
16560;26;0;199;0;225
16561;45;153;0;0;198
16563;30;348;45;0;423
16564;304;706;135;0;1145
16565;36;112;75;0;223
16566;52;477;45;0;574
16567;45;30;165;0;240
16568;0;210;83;0;293
16569;279;158;177;0;614
16570;89;385;360;0;834
16571;35;44;88;0;167
16572;16;91;110;0;217
16573;0;0;0;0;0
16574;31;125;45;0;201
16575;0;273;22;0;295
16577;22;230;90;0;342
16578;24;0;45;0;69
16579;0;0;0;0;0
16580;382;932;388;0;1702
16581;0;0;0;0;0
16582;225;315;294;0;834
16583;150;315;215;0;680
16584;69;136;15;0;220
16585;37;180;0;0;217
16586;69;90;90;0;249
16587;70;524;198;0;792
16588;88;608;478;0;1174
16589;101;604;270;0;975
16590;32;224;67;0;323
16591;16;44;85;0;145
16592;24;135;90;0;249
16594;50;225;135;0;410
16595;16;135;0;0;151
16596;0;300;0;0;300
16597;20;90;0;0;110
16598;75;270;92;0;437
16599;24;176;41;0;241
16600;864;314;366;0;1544
16601;42;272;30;0;344
16602;15;180;45;0;240
16603;78;144;157;0;379
16604;44;90;45;0;179
16605;0;0;0;0;0
16606;9;205;90;0;304
16607;26;61;10;0;97
16608;271;523;283;0;1077
16610;24;180;90;0;294
16611;0;0;0;0;0
16613;16;90;135;0;241
16614;0;0;0;0;0
16615;156;88;396;0;640
16616;6;0;0;0;6
16617;0;159;0;0;159
16618;0;0;0;0;0
16619;108;85;105;0;298
16620;0;0;0;0;0
16621;0;0;0;0;0
16622;13;34;22;0;69
16623;0;139;22;0;161
16624;65;207;465;0;737
16625;127;225;225;0;577
16627;204;188;315;0;707
16629;0;22;0;0;22
16630;48;175;90;0;313
16631;48;112;0;0;160
16632;0;0;0;0;0
16633;24;155;45;0;224
16634;194;643;477;0;1314
16635;0;0;0;0;0
16636;129;315;0;0;444
16637;127;0;45;0;172
16638;0;0;0;0;0
16639;72;90;180;0;342
16640;69;45;135;0;249
16641;0;0;0;0;0
16642;0;90;45;0;135
16644;310;1326;495;0;2131
16645;77;353;45;0;475
16646;46;121;120;0;287
16647;50;165;90;0;305
16648;0;0;0;0;0
16649;54;0;300;0;354
16650;0;0;0;0;0
16651;0;0;0;0;0
16652;270;650;180;0;1100
16653;0;0;0;0;0
16654;69;131;44;0;244
16655;0;0;0;0;0
16656;10;77;33;0;120
16658;0;45;0;0;45
16659;63;113;45;0;221
16661;69;0;315;0;384
16662;21;305;0;0;326
16663;72;205;110;0;387
16664;0;180;45;0;225
16665;0;88;79;0;167
16666;22;88;44;0;154
16667;4;22;0;0;26
16668;26;135;90;0;251
16669;0;0;0;0;0
16670;0;0;0;0;0
16671;94;435;135;0;664
16672;24;111;45;0;180
16673;167;317;294;0;778
16675;35;240;45;0;320
16676;365;1972;880;0;3217
16677;90;496;166;0;752
16678;52;134;179;0;365
16679;9;90;45;0;144
16680;0;0;0;0;0
16681;0;0;0;0;0
16682;0;22;0;0;22
16683;24;90;0;0;114
16684;0;0;0;0;0
16685;261;577;170;0;1008
16686;16;90;142;0;248
16687;41;90;83;0;214
16689;16;243;60;0;319
16690;152;335;135;0;622
16692;40;110;179;0;329
16693;24;90;105;0;219
16694;16;132;225;0;373
16695;264;809;170;0;1243
16696;30;0;0;0;30
16697;81;777;90;0;948
16698;36;0;179;0;215
16699;81;315;90;0;486
16700;0;0;0;0;0
16701;17;45;44;0;106
16702;17;88;44;0;149
16703;112;112;135;0;359
16704;100;964;217;0;1281
16705;0;0;0;0;0
16706;0;0;0;0;0
16708;42;120;40;0;202
16709;26;90;103;0;219
16711;24;299;45;0;368
16712;0;135;15;0;150
16713;104;0;90;0;194
16714;0;0;0;0;0
16715;213;802;300;0;1315
16716;166;632;531;0;1329
16717;50;332;274;0;656
16718;0;106;45;0;151
16719;0;0;0;0;0
16720;0;0;0;0;0
16721;36;107;123;0;266
16722;0;10;34;0;44
16723;0;0;30;0;30
16725;68;135;45;0;248
16726;0;0;0;0;0
16727;16;50;25;0;91
16728;145;792;315;0;1252
16729;172;452;376;0;1000
16730;459;353;208;0;1020
16731;90;230;88;0;408
16732;47;247;90;0;384
16733;123;147;90;0;360
16734;30;241;45;0;316
16735;28;135;67;0;230
16736;0;0;0;0;0
16737;0;0;0;0;0
16739;133;135;270;0;538
16740;30;224;0;0;254
16742;0;0;0;0;0
16743;0;60;17;0;77
16744;133;290;225;0;648
16745;4;0;68;0;72
16746;0;0;20;0;20
16747;88;120;202;0;410
16748;128;256;176;0;560
16749;35;546;90;0;671
16750;0;0;0;0;0
16751;112;594;353;0;1059
16752;10;15;0;0;25
16753;0;276;90;0;366
16754;192;216;519;0;927
16756;8;44;267;0;319
16757;35;283;180;0;498
16758;17;90;45;0;152
16759;48;0;360;0;408
16760;25;30;25;0;80
16761;24;84;0;0;108
16762;30;131;0;0;161
16763;0;0;0;0;0
16764;0;51;0;0;51
16765;0;135;45;0;180
16766;0;90;45;0;135
16767;0;218;0;0;218
16768;0;0;45;0;45
16770;8;740;269;0;1017
16771;0;0;0;0;0
16773;60;237;132;0;429
16774;20;64;44;0;128
16775;44;0;177;0;221
16776;44;724;419;0;1187
16777;0;204;45;0;249
16778;52;45;25;0;122
16779;32;180;45;0;257
16780;111;720;45;0;876
16781;77;247;45;0;369
16782;8;45;45;0;98
16783;30;0;0;0;30
16784;23;22;22;0;67
16785;32;240;0;0;272
16787;89;90;55;0;234
16788;24;225;90;0;339
16789;38;123;8;0;169
16790;122;110;90;0;322
16791;77;90;93;0;260
16792;0;86;44;0;130
16793;2;182;135;0;319
16794;0;20;0;0;20
16795;96;45;45;0;186
16796;0;0;0;0;0
16797;15;66;90;0;171
16798;45;130;113;0;288
16799;4;45;0;0;49
16800;49;90;45;0;184
16801;12;53;89;0;154
16802;17;74;44;0;135
16803;0;130;90;0;220
16804;12;61;0;0;73
16806;12;45;0;0;57
16807;45;135;90;0;270
16808;26;91;115;0;232
16809;100;317;111;0;528
16810;8;45;20;0;73
16811;62;80;74;0;216
16812;24;180;75;0;279
16813;0;0;30;0;30
16814;24;178;45;0;247
16815;0;45;90;0;135
16816;36;225;115;0;376
16817;30;269;100;0;399
16818;0;0;0;0;0
16820;47;18;50;0;115
16821;24;225;45;0;294
16823;62;0;135;0;197
16824;0;0;0;0;0
16825;117;182;65;0;364
16826;32;184;88;0;304
16827;17;90;30;0;137
16828;46;90;45;0;181
16829;0;281;270;0;551
16830;58;88;180;0;326
16831;0;54;67;0;121
16832;24;134;45;0;203
16833;270;0;0;0;270
16834;44;0;22;0;66
16835;0;100;0;0;100
16837;32;180;135;0;347
16838;104;135;148;0;387
16839;32;224;90;0;346
16840;0;25;25;0;50
16842;0;0;0;0;0
16843;112;2086;225;0;2423
16844;49;1477;450;0;1976
16845;23;110;70;0;203
16846;56;193;65;0;314
16847;16;68;45;0;129
16848;14;120;16;0;150
16849;0;25;30;0;55
16850;0;0;0;0;0
16851;172;436;132;0;740
16852;0;0;0;0;0
16854;30;0;0;0;30
16855;0;0;0;0;0
16856;64;323;284;0;671
16857;0;25;25;0;50
16858;81;261;8;0;350
16859;45;0;0;0;45
16860;0;0;0;0;0
16861;0;132;44;0;176
16862;73;225;0;0;298
16863;0;0;0;0;0
16864;35;270;45;0;350
16865;90;270;45;0;405
16866;61;66;66;0;193
16868;41;180;135;0;356
16869;42;66;22;0;130
16871;45;22;0;0;67
16872;0;0;0;0;0
16873;23;157;90;0;270
16874;0;6;0;0;6
16876;23;158;40;0;221
16877;67;22;178;0;267
16878;16;129;144;0;289
16879;288;310;428;0;1026
16880;48;382;180;0;610
16881;133;390;155;0;678
16882;75;30;165;0;270
16883;78;205;103;0;386
16885;0;0;0;0;0
16886;30;270;90;0;390
16887;0;30;64;0;94
16888;16;135;23;0;174
16889;122;135;45;0;302
16890;103;89;88;0;280
16892;0;105;45;0;150
16893;60;104;44;0;208
16894;24;88;0;0;112
16895;148;339;135;0;622
16896;0;0;30;0;30
16897;0;135;35;0;170
16899;68;180;115;0;363
16900;110;0;135;0;245
16901;107;90;45;0;242
16902;61;135;90;0;286
16904;6;0;135;0;141
16905;28;90;135;0;253
16906;28;185;112;0;325
16907;0;0;0;0;0
16908;25;135;123;0;283
16909;61;134;45;0;240
16910;16;0;48;0;64
16911;89;180;45;0;314
16912;8;25;0;0;33
16913;11;0;87;0;98
16914;30;0;180;0;210
16915;44;100;45;0;189
16916;18;45;0;0;63
16918;41;292;40;0;373
16919;139;262;165;0;566
16921;0;159;30;0;189
16922;0;45;45;0;90
16923;180;471;90;0;741
16924;119;180;37;0;336
16925;16;102;95;0;213
16926;42;337;90;0;469
16927;12;90;0;0;102
16928;36;270;45;0;351
16929;53;50;45;0;148
16931;0;783;0;0;783
16932;0;260;45;0;305
16933;34;179;90;0;303
16935;0;84;0;0;84
16936;44;314;90;0;448
16937;150;0;22;0;172
16938;25;135;90;0;250
16939;158;45;90;0;293
16940;0;0;0;0;0
16941;29;169;95;0;293
16942;4;90;90;0;184
16943;0;0;0;0;0
16944;0;0;0;0;0
16945;165;281;90;0;536
16946;72;225;45;0;342
16947;26;180;45;0;251
16949;53;0;0;0;53
16950;0;372;88;0;460
16952;66;0;45;0;111
16953;48;287;133;0;468
16954;42;135;90;0;267
16955;124;565;225;0;914
16956;45;0;159;0;204
16957;24;135;0;0;159
16958;119;584;405;0;1108
16959;16;90;0;0;106
16960;24;0;212;0;236
16961;0;176;45;0;221
16962;8;44;60;0;112
16963;40;67;225;0;332
16964;26;78;25;0;129
16966;31;88;0;0;119
16967;12;44;44;0;100
16968;0;178;90;0;268
16969;0;222;45;0;267
16970;2;196;45;0;243
16971;22;180;135;0;337
16972;60;140;0;0;200
16973;139;45;225;0;409
16974;61;90;45;0;196
16975;103;266;67;0;436
16978;0;0;0;0;0
16980;90;172;225;0;487
16981;0;44;0;0;44
16983;20;100;35;0;155
16984;0;139;135;0;274
16985;80;214;131;0;425
16986;18;85;275;0;378
16987;44;32;252;0;328
16988;54;135;10;0;199
16990;27;0;157;0;184
16991;30;0;148;0;178
16992;68;44;66;0;178
16993;0;90;0;0;90
16994;44;220;154;0;418
16995;50;120;90;0;260
16997;80;144;90;0;314
16998;0;290;45;0;335
16999;25;180;180;0;385
17000;39;42;45;0;126
17001;27;90;45;0;162
17600;179;2238;720;0;3137
17602;0;0;0;0;0
17603;0;0;0;0;0
17604;0;0;0;0;0
17605;265;720;270;0;1255
17606;947;341;539;0;1827
17607;69;765;427;0;1261
17634;265;494;180;0;939
17635;309;596;405;0;1310
17636;5;80;0;0;85
17637;0;0;0;0;0
17638;44;700;45;0;789
17639;0;0;0;0;0
17640;0;0;0;0;0
17641;0;22;22;0;44
17642;45;160;40;0;245
17643;26;315;180;0;521
17644;43;100;35;0;178
17647;18;56;44;0;118
17648;181;486;180;0;847
17649;0;0;0;0;0
17650;88;163;135;0;386
17651;0;0;0;0;0
17652;24;404;135;0;563
17653;0;0;0;0;0
17654;162;326;156;0;644
17655;0;0;0;0;0
17656;0;0;0;0;0
17657;568;1414;511;0;2493
17658;0;0;0;0;0
17659;0;0;0;0;0
17660;91;170;135;0;396
17661;0;0;0;0;0
17662;234;1092;440;0;1766
17664;0;0;0;0;0
17665;0;0;0;0;0
17666;0;0;0;0;0
17667;0;0;0;0;0
17668;0;0;0;0;0
17669;0;0;0;0;0
17670;0;0;0;0;0
17671;0;0;0;0;0
17672;0;0;0;0;0
17673;0;0;0;0;0
17674;0;0;0;0;0
17675;0;0;0;0;0
17678;0;0;0;0;0
17679;123;270;90;0;483
17681;0;0;0;0;0
17682;0;0;0;0;0
17683;0;0;0;0;0
17684;0;0;0;0;0
17685;0;0;0;0;0
17686;110;410;180;0;700
17687;279;1017;600;0;1896
17688;0;0;0;0;0
17689;62;309;90;0;461
17690;67;741;90;0;898
17691;0;0;0;0;0
17692;302;28;74;0;404
17693;162;655;176;0;993
17696;0;0;0;0;0
17697;0;0;0;0;0
17698;298;622;396;0;1316
17699;104;495;135;0;734
17700;0;0;0;0;0
17701;135;45;77;0;257
17702;45;225;180;0;450
17703;549;587;480;0;1616
17704;58;313;89;0;460
17705;0;0;0;0;0
17706;0;0;0;0;0
17707;0;0;0;0;0
17708;101;233;135;0;469
17709;119;250;357;0;726
17710;8;0;0;0;8
17711;10;0;0;0;10
17715;28;45;90;0;163
17716;0;0;0;0;0
17717;0;0;0;0;0
17718;0;143;0;0;143
17719;52;651;230;0;933
17723;142;601;176;0;919
17724;0;0;0;0;0
17725;112;428;315;0;855
17726;0;45;45;0;90
17728;0;247;135;0;382
17731;0;0;269;0;269
17732;110;473;168;0;751
17733;48;337;135;0;520
17734;85;135;90;0;310
17735;131;2463;315;0;2909
17736;289;656;261;0;1206
17737;68;381;133;0;582
17738;0;0;0;0;0
17739;0;90;23;0;113
17740;0;0;0;0;0
17741;101;926;176;0;1203
17742;108;614;88;0;810
17743;0;0;0;0;0
17745;23;601;57;0;681
17746;142;180;117;0;439
17747;0;0;0;0;0
17748;0;0;0;0;0
17749;23;14;15;0;52
17750;467;1013;873;0;2353
17751;210;922;176;0;1308
17753;44;187;45;0;276
17754;0;90;45;0;135
17755;0;0;0;0;0
17756;0;0;0;0;0
17757;0;0;0;0;0
17759;0;0;0;0;0
17760;0;0;0;0;0
17762;20;80;40;0;140
17763;38;172;45;0;255
17764;45;165;180;0;390
17765;415;1223;405;0;2043
17766;164;491;125;0;780
17767;0;42;0;0;42
17768;18;45;29;0;92
17769;0;0;0;0;0
17770;0;0;0;0;0
17771;158;360;135;0;653
17772;0;503;360;0;863
17773;0;0;0;0;0
17774;0;69;0;0;69
17776;80;390;45;0;515
17777;0;0;0;0;0
17778;272;1529;405;0;2206
17779;204;152;346;0;702
17780;0;0;0;0;0
17781;45;182;54;0;281
17782;148;510;308;0;966
17783;0;0;0;0;0
17784;0;189;0;0;189
17785;183;425;133;0;741
17786;0;0;0;0;0
17787;162;1116;220;0;1498
17788;70;321;225;0;616
17790;258;444;432;0;1134
17791;72;292;90;0;454
17793;273;1207;270;0;1750
17794;592;1754;450;0;2796
17795;0;119;0;0;119
17796;45;225;90;0;360
17797;48;423;145;0;616
17798;28;90;90;0;208
17799;25;90;133;0;248
17800;240;514;376;0;1130
17801;0;0;45;0;45
17802;98;160;45;0;303
17803;0;0;0;0;0
17804;0;0;0;0;0
17805;0;0;0;0;0
17806;0;10;0;0;10
17807;54;405;90;0;549
17809;98;292;45;0;435
17810;440;270;135;0;845
17812;269;553;225;0;1047
17813;147;1008;220;0;1375
17814;210;1077;221;0;1508
17815;85;171;135;0;391
17816;196;202;90;0;488
17817;45;170;390;0;605
17818;45;514;225;0;784
17819;0;0;0;0;0
17820;0;0;0;0;0
17821;0;83;21;0;104
17822;278;165;225;0;668
17823;114;112;130;0;356
17824;0;165;144;0;309
17826;0;0;0;0;0
17827;0;0;0;0;0
17828;30;915;135;0;1080
17829;45;45;45;0;135
17830;30;135;67;0;232
17832;232;225;106;0;563
17833;497;756;450;0;1703
17834;85;360;113;0;558
17835;45;0;90;0;135
17836;22;199;44;0;265
17837;18;93;134;0;245
17838;47;843;360;0;1250
17840;24;256;180;0;460
17841;0;0;0;0;0
17843;228;315;405;0;948
17844;0;0;0;0;0
17845;0;0;0;0;0
17846;28;25;25;0;78
17847;67;88;44;0;199
17848;167;825;469;0;1461
17849;0;0;0;0;0
17850;342;835;225;0;1402
17851;0;0;0;0;0
17852;77;225;180;0;482
17854;148;360;180;0;688
17855;245;588;665;0;1498
17857;35;227;135;0;397
17858;245;896;534;0;1675
17859;802;0;657;0;1459
17860;183;374;320;0;877
17861;0;45;25;0;70
17862;0;0;0;0;0
17863;45;181;75;0;301
17864;0;0;0;0;0
17865;22;65;33;0;120
17866;0;0;0;0;0
17867;0;0;0;0;0
17868;0;355;0;0;355
17869;0;0;0;0;0
17870;0;20;0;0;20
17871;0;30;40;0;70
17872;156;477;191;0;824
17874;154;836;176;0;1166
17875;429;170;787;0;1386
17876;233;495;450;0;1178
17877;42;1188;270;0;1500
17878;28;178;45;0;251
17879;0;85;80;0;165
17880;0;0;0;0;0
17881;94;312;88;0;494
17882;0;90;45;0;135
17883;109;646;45;0;800
17884;39;67;90;0;196
17885;406;792;440;0;1638
17886;58;470;130;0;658
17888;45;0;180;0;225
17889;25;148;42;0;215
17891;0;0;0;0;0
17892;232;670;380;0;1282
17893;0;0;0;0;0
17894;98;154;80;0;332
17895;232;1137;40;0;1409
17896;0;0;0;0;0
17897;241;900;220;0;1361
17898;313;1408;88;0;1809
17899;92;0;390;0;482
17900;95;427;180;0;702
17901;51;92;134;0;277
17902;150;663;180;0;993
17903;233;702;583;0;1518
17904;0;0;0;0;0
17905;0;0;0;0;0
17907;6;327;180;0;513
17908;498;1291;449;0;2238
17909;0;0;0;0;0
17910;40;315;45;0;400
17911;271;45;135;0;451
17912;609;160;360;0;1129
17913;0;0;0;0;0
17914;54;0;305;0;359
17915;259;720;585;0;1564
17916;374;1316;280;0;1970
17917;0;90;25;0;115
17918;80;1340;495;0;1915
17920;285;985;383;0;1653
17921;0;0;0;0;0
17922;181;1;45;0;227
17924;194;475;336;0;1005
17925;45;404;67;0;516
17926;70;345;90;0;505
17927;0;0;0;0;0
17928;0;40;0;0;40
17930;178;548;176;0;902
17931;117;102;225;0;444
18001;100;79;45;0;224
18002;157;904;228;0;1289
18003;27;0;180;0;207
18004;140;713;308;0;1161
18006;176;719;396;0;1291
18007;287;1105;586;0;1978
18008;148;583;180;0;911
18009;62;329;88;0;479
18010;34;565;90;0;689
18011;68;0;448;0;516
18012;181;1209;308;0;1698
18014;119;268;132;0;519
18015;109;88;132;0;329
18016;115;848;264;0;1227
18017;367;806;308;0;1481
18018;0;20;0;0;20
18020;53;45;314;0;412
18021;179;818;154;0;1151
18023;0;0;30;0;30
18024;56;180;90;0;326
18025;48;155;45;0;248
18026;134;225;225;0;584
18027;69;45;135;0;249
18028;286;1125;630;0;2041
18029;51;314;45;0;410
18030;87;180;135;0;402
18031;18;143;45;0;206
18032;20;237;177;0;434
18033;0;0;0;0;0
18034;259;713;292;0;1264
18035;196;768;332;0;1296
18037;44;386;176;0;606
18038;83;180;180;0;443
18039;44;0;90;0;134
18040;77;413;0;0;490
18041;0;0;0;0;0
18042;577;205;835;0;1617
18043;0;114;44;0;158
18044;38;67;90;0;195
18045;8;294;45;0;347
18046;0;0;0;0;0
18047;0;0;0;0;0
18048;19;90;45;0;154
18049;163;972;495;0;1630
18050;157;195;225;0;577
18051;61;0;261;0;322
18052;47;212;45;0;304
18054;25;74;44;0;143
18055;0;0;0;0;0
18061;24;135;90;0;249
18062;66;88;44;0;198
18063;27;0;225;0;252
18064;10;45;45;0;100
18065;202;1144;616;0;1962
18066;135;180;360;0;675
18068;0;0;0;0;0
18069;89;325;166;0;580
18071;0;0;0;0;0
18072;0;0;0;0;0
18073;44;365;0;0;409
18074;28;270;45;0;343
18075;115;75;180;0;370
18076;0;0;90;0;90
18077;6;115;45;0;166
18078;24;135;45;0;204
18079;39;113;45;0;197
18080;121;484;308;0;913
18081;26;225;135;0;386
18082;60;90;45;0;195
18085;32;339;102;0;473
18086;0;0;0;0;0
18087;188;577;648;0;1413
18088;51;45;45;0;141
18089;20;44;0;0;64
18090;0;147;224;0;371
18091;38;270;90;0;398
18092;8;147;69;0;224
18093;162;594;180;0;936
18094;88;557;90;0;735
18095;90;20;45;0;155
18096;9;178;35;0;222
18097;687;0;720;0;1407
18099;129;868;176;0;1173
18100;0;0;0;0;0
18101;16;112;134;0;262
18102;194;550;142;0;886
18104;68;840;45;0;953
18105;124;203;45;0;372
18106;30;271;45;0;346
18107;18;90;0;0;108
18108;16;155;70;0;241
18109;80;449;135;0;664
18110;0;28;0;0;28
18111;243;445;225;0;913
18112;88;810;308;0;1206
18113;65;112;85;0;262
18114;120;200;230;0;550
18115;0;0;0;0;0
18116;0;0;0;0;0
18118;0;0;0;0;0
18119;51;204;90;0;345
18121;50;309;49;0;408
18122;0;106;90;0;196
18123;101;839;135;0;1075
18124;69;675;568;0;1312
18125;0;0;0;0;0
18126;230;450;135;0;815
18127;107;593;225;0;925
18128;79;691;225;0;995
18130;80;403;192;0;675
18131;45;363;0;0;408
18132;117;382;90;0;589
18133;109;0;220;0;329
18138;61;45;0;0;106
18139;20;132;0;0;152
18140;20;45;0;0;65
18141;0;0;0;0;0
18142;133;380;135;0;648
18143;76;255;122;0;453
18144;22;99;135;0;256
18145;7;20;0;0;27
18146;0;116;44;0;160
18147;358;990;466;0;1814
18149;395;855;291;0;1541
18150;399;0;45;0;444
18152;65;83;45;0;193
18153;36;133;90;0;259
18154;24;0;217;0;241
18155;19;88;44;0;151
18156;16;180;75;0;271
18157;16;165;45;0;226
18158;84;405;45;0;534
18159;16;30;225;0;271
18160;0;129;112;0;241
18161;0;0;0;0;0
18162;18;225;72;0;315
18163;125;340;270;0;735
18164;28;135;0;0;163
18166;0;225;90;0;315
18167;24;0;160;0;184
18168;28;158;90;0;276
18169;91;180;146;0;417
18170;84;355;180;0;619
18172;422;907;500;0;1829
18173;67;45;181;0;293
18175;10;0;45;0;55
18176;82;90;90;0;262
18177;0;0;0;0;0
18178;29;180;45;0;254
18180;0;30;10;0;40
18181;380;720;270;0;1370
18183;86;195;45;0;326
18184;124;393;207;0;724
18185;0;0;0;0;0
18186;0;0;0;0;0
18187;0;0;0;0;0
18188;36;90;45;0;171
18189;22;235;45;0;302
18190;21;135;45;0;201
18191;76;305;90;0;471
18192;16;110;90;0;216
18193;21;112;45;0;178
18194;45;65;198;0;308
18195;49;890;154;0;1093
18197;73;224;175;0;472
18198;0;0;0;0;0
18199;237;495;225;0;957
18200;86;135;45;0;266
18202;65;157;45;0;267
18203;73;241;85;0;399
18204;86;0;89;0;175
18205;40;180;75;0;295
18206;25;0;222;0;247
18207;25;225;107;0;357
18208;45;225;180;0;450
18209;90;135;45;0;270
18210;71;155;22;0;248
18211;20;90;20;0;130
18212;0;0;74;0;74
18213;52;209;45;0;306
18214;32;218;0;0;250
18216;0;450;202;0;652
18217;0;0;0;0;0
18218;300;916;176;0;1392
18219;23;0;95;0;118
18220;158;1077;327;0;1562
18221;0;0;0;0;0
18222;77;135;180;0;392
18223;227;54;217;0;498
18224;24;0;238;0;262
18225;37;198;45;0;280
18226;186;495;135;0;816
18227;199;308;0;0;507
18228;0;0;0;0;0
18230;0;106;45;0;151
18231;34;176;195;0;405
18233;108;0;10;0;118
18234;116;45;45;0;206
18235;30;119;25;0;174
18236;70;225;45;0;340
18237;365;674;520;0;1559
18238;0;225;87;0;312
18239;32;270;175;0;477
18240;0;20;0;0;20
18241;125;150;70;0;345
18242;0;0;0;0;0
18243;100;335;45;0;480
18244;114;235;180;0;529
18245;118;135;90;0;343
18247;28;351;237;0;616
18248;0;22;6;0;28
18249;113;357;135;0;605
18250;52;45;62;0;159
18251;62;270;173;0;505
18252;0;200;15;0;215
18253;107;180;90;0;377
18254;20;151;0;0;171
18255;117;0;23;0;140
19630;61;90;45;0;196
19902;0;0;0;0;0
19903;0;0;0;0;0
19904;45;359;112;0;516
19906;308;994;352;0;1654
19907;114;532;45;0;691
19908;275;570;652;0;1497
19909;0;0;0;0;0
19910;20;0;30;0;50
19911;26;0;10;0;36
19912;0;39;32;0;71
19913;206;596;352;0;1154
19914;26;180;44;0;250
19918;54;456;44;0;554
19919;0;10;79;0;89
19921;62;469;135;0;666
19922;71;103;146;0;320
19923;6;120;90;0;216
19925;40;350;225;0;615
19926;0;210;45;0;255
19927;65;660;0;0;725
19928;44;423;113;0;580
19930;0;28;22;0;50
19931;14;0;44;0;58
19933;0;0;0;0;0
19934;7;64;44;0;115
19935;0;0;0;0;0
19937;0;0;0;0;0
19939;0;0;0;0;0
19942;0;0;0;0;0
19943;0;0;0;0;0
19944;0;40;45;0;85
19945;44;147;44;0;235
19947;72;404;45;0;521
19948;0;0;0;0;0
19949;45;240;190;0;475
19950;80;422;45;0;547
19951;0;0;28;0;28
19952;497;1585;405;0;2487
19953;23;181;338;0;542
19954;60;164;537;0;761
19955;0;0;0;0;0
19956;0;0;0;0;0
19957;0;0;0;0;0
19958;0;64;20;0;84
19959;0;135;45;0;180
19960;82;90;130;0;302
19961;0;0;0;0;0
19962;0;45;0;0;45
19964;27;220;90;0;337
19965;180;514;44;0;738
19966;0;0;0;0;0
19967;0;0;0;0;0
19968;161;660;180;0;1001
19969;118;0;0;0;118
19970;0;0;0;0;0
19971;0;0;0;0;0
19972;0;615;180;0;795
19973;33;315;90;0;438
19974;715;1176;190;0;2081
19975;0;0;0;0;0
19976;0;0;0;0;0
19978;0;0;0;0;0
19979;0;0;0;0;0
19981;90;160;270;0;520
19982;0;0;0;0;0
19983;417;1170;540;0;2127
19984;24;135;30;0;189
19985;0;0;0;0;0
19986;0;0;0;0;0
19987;0;0;0;0;0
19988;0;0;0;0;0
19990;0;0;0;0;0
19992;0;0;0;0;0
19993;2;314;132;0;448
19996;38;0;55;0;93
19997;0;0;0;0;0
19998;0;0;0;0;0
19999;0;178;22;0;200
20001;0;62;135;0;197
20002;81;221;183;0;485
20003;0;0;0;0;0
20004;0;0;0;0;0
20006;0;0;0;0;0
20007;0;0;0;0;0
20008;30;270;135;0;435
20009;0;0;0;0;0
20010;0;40;94;0;134
20011;0;0;0;0;0
20012;122;48;33;0;203
20013;0;30;40;0;70
20015;0;15;0;0;15
20016;147;835;700;0;1682
20017;0;0;0;0;0
20018;0;0;0;0;0
20019;200;506;90;0;796
20021;0;0;0;0;0
20022;0;0;0;0;0
20023;0;0;0;0;0
20024;58;149;93;0;300
20025;546;798;588;0;1932
20026;0;20;40;0;60
20027;12;40;44;0;96
20029;17;95;20;0;132
20030;32;219;120;0;371
20032;0;0;0;0;0
20033;20;90;60;0;170
20034;0;0;0;0;0
20035;0;0;0;0;0
20036;0;0;0;0;0
20037;58;494;235;0;787
20038;0;0;0;0;0
20039;0;0;0;0;0
20040;0;0;0;0;0
20041;99;754;180;0;1033
20042;80;360;65;0;505
20043;0;44;118;0;162
20044;0;45;45;0;90
20046;151;457;160;0;768
20047;45;0;22;0;67
20048;179;180;270;0;629
20049;0;0;0;0;0
20050;0;0;0;0;0
20051;0;0;0;0;0
20052;118;495;290;0;903
20053;44;88;88;0;220
20054;0;5;60;0;65
20055;0;0;0;0;0
20056;0;0;0;0;0
20057;0;0;0;0;0
20058;113;394;88;0;595
20060;0;0;0;0;0
20061;0;0;0;0;0
20063;94;30;90;0;214
20064;55;314;45;0;414
20065;45;0;26;0;71
20066;0;4;0;0;4
20067;20;124;105;0;249
20068;103;134;180;0;417
20069;0;0;0;0;0
20070;22;22;44;0;88
20071;202;315;112;0;629
20072;0;0;0;0;0
20073;3;40;0;0;43
20074;101;324;397;0;822
20075;0;0;0;0;0
20077;0;0;0;0;0
20078;0;45;45;0;90
20079;0;0;0;0;0
20080;32;80;40;0;152
20081;0;0;0;0;0
20082;45;852;45;0;942
20083;0;0;0;0;0
20084;28;76;65;0;169
20085;30;296;255;0;581
20086;0;0;0;0;0
20087;164;111;176;0;451
20088;16;132;88;0;236
20089;79;57;0;0;136
20090;160;109;180;0;449
20091;0;0;0;0;0
20092;0;0;0;0;0
20094;0;4;4;0;8
20095;28;135;135;0;298
20096;130;78;115;0;323
20097;60;135;135;0;330
20098;0;0;0;0;0
20099;55;74;99;0;228
20100;22;225;133;0;380
20101;0;0;0;0;0
20102;40;80;0;0;120
20103;220;616;370;0;1206
20104;0;0;0;0;0
20105;0;0;0;0;0
20106;0;143;0;0;143
20107;0;0;0;0;0
20108;262;871;377;0;1510
20110;0;0;0;0;0
20111;0;0;0;0;0
20113;165;107;88;0;360
20114;26;40;45;0;111
20115;0;0;0;0;0
20116;0;0;0;0;0
20117;0;69;0;0;69
20118;0;0;0;0;0
20119;0;90;45;0;135
20120;146;330;120;0;596
20121;125;566;176;0;867
20122;36;75;42;0;153
20123;0;0;0;0;0
20124;0;0;0;0;0
20125;0;0;0;0;0
20127;50;315;205;0;570
20129;113;363;165;0;641
20130;0;0;0;0;0
20131;0;40;45;0;85
20132;0;0;0;0;0
20133;91;591;50;0;732
20134;0;0;0;0;0
20135;0;0;0;0;0
20136;0;231;45;0;276
20137;90;315;315;0;720
20138;0;0;0;0;0
20139;121;180;247;0;548
20140;65;277;115;0;457
20141;0;0;134;0;134
20142;0;90;0;0;90
20144;0;15;75;0;90
20145;61;371;72;0;504
20146;0;0;0;0;0
20147;0;0;0;0;0
20148;0;0;0;0;0
20149;0;0;0;0;0
20150;0;0;0;0;0
20151;0;75;20;0;95
20152;37;71;0;0;108
20153;83;289;135;0;507
20154;171;270;225;0;666
20155;59;289;45;0;393
20156;0;180;45;0;225
20158;80;44;112;0;236
20159;540;607;288;0;1435
20161;42;146;206;0;394
20162;227;90;180;0;497
20164;90;496;90;0;676
20165;19;44;85;0;148
20166;0;0;0;0;0
20167;135;372;405;0;912
20168;45;120;10;0;175
20169;0;0;0;0;0
20170;0;0;0;0;0
20171;0;0;0;0;0
20172;0;0;0;0;0
20173;303;846;315;0;1464
20175;0;220;308;0;528
20176;42;44;66;0;152
20177;0;0;0;0;0
20178;55;91;22;0;168
20179;0;0;0;0;0
20180;62;367;355;0;784
20181;130;521;270;0;921
20182;172;307;135;0;614
20183;0;0;0;0;0
20184;0;0;40;0;40
20185;0;0;0;0;0
20186;57;383;75;0;515
20187;12;38;12;0;62
20189;0;0;0;0;0
20190;0;135;0;0;135
20192;0;0;0;0;0
20193;2;16;70;0;88
20194;45;85;89;0;219
20195;0;0;196;0;196
20196;0;0;16;0;16
20197;0;40;40;0;80
20198;0;0;0;0;0
20199;0;0;0;0;0
20200;194;380;498;0;1072
20201;0;0;44;0;44
20202;45;360;180;0;585
20203;101;450;45;0;596
20204;64;15;270;0;349
20205;45;900;180;0;1125
20206;18;0;335;0;353
20208;0;0;4;0;4
20209;54;412;90;0;556
20211;0;45;0;0;45
20212;203;278;134;0;615
20213;179;622;295;0;1096
20214;45;65;45;0;155
20215;59;682;90;0;831
20216;0;80;20;0;100
20217;0;0;0;0;0
20218;0;122;67;0;189
20219;202;621;90;0;913
20220;0;0;0;0;0
20221;0;90;45;0;135
20222;45;78;0;0;123
20223;87;461;45;0;593
20225;45;300;89;0;434
20226;188;575;225;0;988
20227;74;31;130;0;235
20228;65;135;22;0;222
20229;0;0;0;0;0
20230;0;0;90;0;90
20231;10;24;45;0;79
20232;30;21;0;0;51
20233;0;0;35;0;35
20234;90;90;90;0;270
20235;0;0;0;0;0
20236;0;0;0;0;0
20237;16;0;132;0;148
20239;58;270;295;0;623
20240;24;135;45;0;204
20242;25;270;90;0;385
20243;74;315;60;0;449
20244;6;29;65;0;100
20245;0;30;18;0;48
20246;100;315;45;0;460
20247;0;272;165;0;437
20248;88;484;176;0;748
20249;0;0;0;0;0
20250;93;315;45;0;453
20251;0;0;0;0;0
20252;47;427;45;0;519
20253;0;0;0;0;0
20254;0;0;0;0;0
20256;0;0;50;0;50
20257;107;270;113;0;490
20258;120;1209;630;0;1959
20259;6;170;257;0;433
20260;40;120;45;0;205
20261;10;45;0;0;55
20262;0;0;0;0;0
20263;98;315;180;0;593
20264;24;90;90;0;204
20265;299;746;180;0;1225
20266;139;308;264;0;711
20267;0;133;45;0;178
20268;45;359;45;0;449
20270;12;0;90;0;102
20271;99;180;67;0;346
20273;17;124;102;0;243
20274;59;205;158;0;422
20275;0;45;0;0;45
20276;174;202;90;0;466
20277;0;53;0;0;53
20278;0;65;0;0;65
20279;0;0;44;0;44
20280;0;0;0;0;0
20281;61;242;73;0;376
20282;130;65;265;0;460
20283;9;208;0;0;217
20284;44;180;135;0;359
20285;0;222;133;0;355
20287;26;232;45;0;303
20288;44;170;0;0;214
20289;12;112;90;0;214
20290;106;411;270;0;787
20291;28;225;90;0;343
20292;28;210;45;0;283
20293;82;220;176;0;478
20294;18;114;226;0;358
20295;44;135;45;0;224
20296;269;90;45;0;404
20297;0;0;22;0;22
20298;241;113;313;0;667
20299;0;0;0;0;0
20300;40;270;120;0;430
20301;24;65;0;0;89
20302;39;67;45;0;151
20303;85;45;45;0;175
20304;16;88;0;0;104
20306;22;180;45;0;247
20307;0;0;0;0;0
20308;0;360;180;0;540
20309;0;0;0;0;0
20310;420;83;70;0;573
20311;0;0;0;0;0
20312;0;0;0;0;0
20313;124;221;135;0;480
20314;112;0;199;0;311
20315;0;260;45;0;305
20316;155;135;45;0;335
20317;83;90;180;0;353
20318;0;45;15;0;60
20320;0;0;0;0;0
20321;32;157;45;0;234
20323;0;163;90;0;253
20324;135;270;90;0;495
20325;0;144;112;0;256
20326;20;16;0;0;36
20327;62;90;40;0;192
20328;61;0;90;0;151
20329;18;22;100;0;140
20330;38;98;90;0;226
20331;25;132;45;0;202
20332;107;0;179;0;286
20333;0;0;0;0;0
20334;30;302;90;0;422
20335;48;45;315;0;408
20338;86;90;45;0;221
20339;36;279;90;0;405
20340;17;157;51;0;225
20341;0;296;178;0;474
20342;0;66;44;0;110
20343;0;60;135;0;195
20344;7;158;40;0;205
20345;18;152;45;0;215
20346;27;180;45;0;252
20347;57;30;45;0;132
20348;39;520;270;0;829
20349;0;58;66;0;124
20350;88;132;133;0;353
20351;46;90;45;0;181
20352;135;260;90;0;485
20354;109;180;70;0;359
20355;9;89;45;0;143
20356;22;45;45;0;112
20357;0;236;45;0;281
20358;65;45;22;0;132
20359;0;40;20;0;60
20360;36;65;135;0;236
20361;100;0;40;0;140
20362;0;22;44;0;66
20363;75;298;90;0;463
20364;585;585;360;0;1530
20365;13;177;0;0;190
20366;44;135;33;0;212
20368;56;337;120;0;513
20369;15;5;36;0;56
20371;28;0;110;0;138
20372;70;340;90;0;500
20373;16;90;45;0;151
20374;0;66;8;0;74
20375;77;135;90;0;302
20376;409;1305;528;0;2242
20377;59;90;44;0;193
20378;0;28;20;0;48
20379;15;90;45;0;150
20380;0;40;0;0;40
20381;26;160;45;0;231
20382;0;0;0;0;0
20383;44;315;45;0;404
20385;16;90;0;0;106
20386;32;0;125;0;157
20387;15;67;45;0;127
20388;0;30;0;0;30
20389;61;135;0;0;196
20390;72;258;113;0;443
20391;23;270;0;0;293
20392;5;30;79;0;114
20393;88;250;88;0;426
20395;242;69;89;0;400
20396;0;0;0;0;0
20397;48;135;30;0;213
20399;0;0;20;0;20
20400;0;0;0;0;0
20401;54;225;135;0;414
20402;46;20;60;0;126
20404;48;52;92;0;192
20405;32;135;0;0;167
20406;90;90;90;0;270
20407;8;116;45;0;169
20408;77;115;90;0;282
20409;0;88;0;0;88
20410;26;322;45;0;393
20411;0;0;57;0;57
20412;52;318;45;0;415
20413;28;231;112;0;371
20414;44;285;112;0;441
20416;90;135;45;0;270
20418;12;45;45;0;102
20419;30;0;23;0;53
20421;0;151;20;0;171
20422;0;34;89;0;123
20423;41;45;45;0;131
20424;175;720;225;0;1120
20425;20;55;90;0;165
20426;55;0;90;0;145
20427;448;518;132;0;1098
20428;0;0;0;0;0
20429;78;292;145;0;515
20430;8;45;45;0;98
20431;114;390;45;0;549
20432;75;0;113;0;188
20433;15;90;20;0;125
20435;64;45;73;0;182
20436;91;270;180;0;541
20437;84;297;72;0;453
20438;32;180;45;0;257
20439;24;88;44;0;156
20440;99;352;232;0;683
20441;0;0;0;0;0
20442;0;90;30;0;120
20443;70;140;40;0;250
20444;0;899;135;0;1034
20445;71;583;135;0;789
20446;0;0;135;0;135
20447;41;57;180;0;278
20449;65;45;245;0;355
20450;24;180;45;0;249
20452;0;115;45;0;160
20454;16;45;45;0;106
20455;45;148;90;0;283
20456;77;155;75;0;307
20457;14;135;45;0;194
20458;61;45;45;0;151
20460;202;390;270;0;862
20461;14;225;270;0;509
20462;167;0;45;0;212
20463;24;88;89;0;201
20464;0;0;0;0;0
20466;75;308;240;0;623
20467;0;176;45;0;221
20468;0;22;0;0;22
20469;140;88;110;0;338
20470;45;180;90;0;315
20471;0;0;0;0;0
20472;102;315;45;0;462
20473;0;90;45;0;135
20474;0;135;0;0;135
20475;0;64;44;0;108
20476;0;0;0;0;0
20477;44;30;0;0;74
20478;180;45;675;0;900
20480;31;45;45;0;121
20481;0;0;0;0;0
20483;0;135;69;0;204
20484;16;0;0;0;16
20485;0;45;45;0;90
20486;16;133;0;0;149
20487;0;100;98;0;198
20488;0;0;0;0;0
20489;44;177;0;0;221
20490;16;40;180;0;236
20491;25;151;45;0;221
20492;75;32;44;0;151
20493;22;124;45;0;191
20494;30;15;23;0;68
20495;0;0;0;0;0
20497;17;20;23;0;60
20498;0;80;0;0;80
20500;144;364;45;0;553
20502;271;0;183;0;454
20503;0;44;32;0;76
20504;44;0;120;0;164
20505;74;0;0;0;74
20506;0;0;0;0;0
20507;314;268;450;0;1032
20508;194;314;680;0;1188
20509;0;25;0;0;25
20510;0;0;20;0;20
20511;28;40;182;0;250
20512;45;162;132;0;339
20513;0;45;0;0;45
20514;0;53;45;0;98
20516;0;30;45;0;75
20517;45;45;0;0;90
20518;0;228;90;0;318
20519;135;170;115;0;420
20520;56;264;0;0;320
20526;20;360;90;0;470
20533;6;45;34;0;85
20549;34;118;88;0;240
20562;49;225;0;0;274
20564;0;67;0;0;67
20566;0;90;0;0;90
20567;0;0;16;0;16
20582;157;90;45;0;292
20585;0;149;23;0;172
20586;0;0;0;0;0
20592;16;45;45;0;106
20593;64;160;0;0;224
20600;8;0;0;0;8
20601;243;0;180;0;423
20604;0;299;45;0;344
20629;69;180;45;0;294
20631;0;20;0;0;20
20632;0;180;0;0;180
20634;85;135;90;0;310
20638;19;84;0;0;103
20663;0;0;0;0;0
20665;0;0;0;0;0
20691;201;37;275;0;513
21123;0;0;0;0;0
22000;0;0;0;0;0
22001;0;0;0;0;0
22002;0;0;0;0;0
22004;35;135;180;0;350
22007;126;934;495;0;1555
22008;0;0;0;0;0
22009;219;654;163;0;1036
22010;161;1097;135;0;1393
22011;0;0;0;0;0
22012;100;440;396;0;936
22013;41;115;45;0;201
22014;114;496;347;0;957
22015;0;0;0;0;0
22016;0;0;0;0;0
22017;0;0;0;0;0
22019;85;572;210;0;867
22020;0;119;0;0;119
22021;164;538;220;0;922
22022;220;440;220;0;880
22024;76;682;270;0;1028
22025;4;38;20;0;62
22026;0;0;0;0;0
22027;44;528;220;0;792
22028;0;0;0;0;0
22029;0;90;90;0;180
22030;0;0;0;0;0
22031;0;0;0;0;0
22032;0;0;0;0;0
22034;0;0;0;0;0
22036;0;0;0;0;0
22038;0;0;0;0;0
22039;0;0;0;0;0
22041;65;450;90;0;605
22042;0;0;0;0;0
22043;0;0;0;0;0
22044;0;0;0;0;0
22045;0;0;0;0;0
22046;0;0;0;0;0
22048;11;0;0;0;11
22049;0;76;0;0;76
22050;88;230;132;0;450
22051;57;160;15;0;232
22053;0;0;0;0;0
22055;0;0;0;0;0
22056;0;0;0;0;0
22057;0;0;0;0;0
22058;0;0;0;0;0
22059;0;0;0;0;0
22060;0;0;0;0;0
22061;0;0;0;0;0
22062;30;940;405;0;1375
22063;0;0;0;0;0
22064;0;0;0;0;0
22065;406;955;0;0;1361
22066;0;0;40;0;40
22067;0;0;0;0;0
22070;0;84;0;0;84
22072;0;0;22;0;22
22073;0;0;0;0;0
22075;0;0;0;0;0
22076;0;0;0;0;0
22077;0;0;0;0;0
22078;40;221;45;0;306
22079;0;0;0;0;0
22080;0;0;0;0;0
22081;0;0;0;0;0
22083;168;720;563;0;1451
22084;52;232;88;0;372
22086;159;598;264;0;1021
22087;0;0;0;0;0
22088;0;0;0;0;0
22089;0;0;44;0;44
22091;14;292;45;0;351
22092;0;40;0;0;40
22093;0;0;0;0;0
22094;244;442;90;0;776
22095;0;0;0;0;0
22096;52;0;19;0;71
22097;0;225;180;0;405
22098;0;8;25;0;33
22100;22;25;30;0;77
22101;198;451;88;0;737
22102;0;0;0;0;0
22103;60;75;135;0;270
22105;284;1534;484;0;2302
22107;0;0;0;0;0
22108;0;0;0;0;0
22109;0;0;0;0;0
22110;0;0;0;0;0
22111;0;98;0;0;98
22112;36;36;0;0;72
22113;118;528;440;0;1086
22114;45;279;45;0;369
22115;0;0;0;0;0
22116;0;0;0;0;0
22117;0;0;0;0;0
22119;0;0;0;0;0
22120;0;0;0;0;0
22122;0;0;0;0;0
22123;0;0;0;0;0
22125;0;30;0;0;30
22127;0;0;0;0;0
22128;0;0;0;0;0
22129;0;0;0;0;0
22130;188;834;391;0;1413
22133;40;360;45;0;445
22134;0;80;44;0;124
22136;0;0;0;0;0
22137;0;10;100;0;110
22138;0;34;22;0;56
22139;0;104;45;0;149
22140;255;1402;810;0;2467
22141;0;0;0;0;0
22142;0;4;0;0;4
22143;0;0;0;0;0
22144;0;0;42;0;42
22145;5;0;0;0;5
22146;28;229;45;0;302
22147;0;60;0;0;60
22148;0;30;0;0;30
22151;150;478;176;0;804
22153;0;40;0;0;40
22154;0;0;0;0;0
22155;60;505;305;0;870
22156;0;61;45;0;106
22157;0;0;0;0;0
22158;72;138;135;0;345
22159;0;57;0;0;57
22160;40;295;100;0;435
22161;0;0;0;0;0
22162;0;45;45;0;90
22163;0;0;0;0;0
22164;0;0;0;0;0
22165;32;118;40;0;190
22167;0;0;0;0;0
22168;0;0;0;0;0
22169;0;0;0;0;0
22170;0;0;0;0;0
22171;0;0;0;0;0
22172;0;0;0;0;0
22173;0;60;25;0;85
22174;0;0;0;0;0
22175;367;699;186;0;1252
22176;92;710;220;0;1022
22177;0;88;220;0;308
22178;0;0;0;0;0
22179;0;0;0;0;0
22180;0;0;0;0;0
22181;0;43;30;0;73
22182;0;0;0;0;0
22184;54;38;0;0;92
22185;0;0;0;0;0
22186;135;32;155;0;322
22187;257;68;71;0;396
22188;0;45;34;0;79
22189;0;90;50;0;140
22190;0;0;0;0;0
22191;440;912;405;0;1757
22192;168;992;405;0;1565
22193;0;0;0;0;0
22194;0;0;0;0;0
22195;87;328;44;0;459
22196;139;342;135;0;616
22198;0;0;0;0;0
22199;0;0;0;0;0
22200;96;650;160;0;906
22201;83;135;22;0;240
22203;0;94;38;0;132
22204;44;220;0;0;264
22205;0;0;0;0;0
22206;0;0;0;0;0
22207;0;0;0;0;0
22208;0;0;0;0;0
22209;0;0;0;0;0
22210;58;405;160;0;623
22211;47;739;279;0;1065
22212;0;0;0;0;0
22213;0;0;0;0;0
22214;0;0;0;0;0
22215;0;0;0;0;0
22217;0;0;0;0;0
22218;55;45;165;0;265
22219;0;116;0;0;116
22220;0;0;84;0;84
22221;36;20;0;0;56
22222;0;0;0;0;0
22223;31;45;135;0;211
22224;216;111;242;0;569
22225;0;77;0;0;77
22226;218;281;230;0;729
22227;0;0;0;0;0
22228;0;45;50;0;95
22229;307;726;264;0;1297
22230;130;208;45;0;383
22231;298;305;285;0;888
22232;0;0;0;0;0
22234;173;558;498;0;1229
22235;0;0;0;0;0
22236;250;180;270;0;700
22237;0;0;0;0;0
22238;12;90;22;0;124
22239;0;0;0;0;0
22240;4;240;88;0;332
22241;0;0;0;0;0
22242;0;0;0;0;0
22243;0;0;0;0;0
22244;0;0;0;0;0
22245;0;0;35;0;35
22246;40;495;90;0;625
22248;20;371;90;0;481
22249;0;0;28;0;28
22251;0;0;0;0;0
22252;0;0;0;0;0
22253;88;120;30;0;238
22254;0;0;0;0;0
22255;0;135;157;0;292
22256;26;180;22;0;228
22257;0;162;0;0;162
22258;0;22;20;0;42
22259;0;180;30;0;210
22260;216;352;132;0;700
22261;0;65;15;0;80
22262;60;543;308;0;911
22263;0;80;80;0;160
22265;47;258;0;0;305
22266;0;0;0;0;0
22267;32;45;90;0;167
22268;0;38;0;0;38
22269;0;0;0;0;0
22270;211;80;62;0;353
22271;216;411;387;0;1014
22272;0;0;0;0;0
22273;0;0;0;0;0
22274;0;0;0;0;0
22275;74;751;170;0;995
22276;30;390;150;0;570
22277;0;307;90;0;397
22279;0;0;0;0;0
22280;0;82;0;0;82
22282;79;0;270;0;349
22283;162;90;90;0;342
22284;32;0;0;0;32
22285;0;0;0;0;0
22286;0;0;0;0;0
22287;0;0;0;0;0
22288;0;0;0;0;0
22289;0;0;0;0;0
22290;0;0;0;0;0
22291;0;0;40;0;40
22292;0;0;0;0;0
22293;64;206;44;0;314
22294;53;160;45;0;258
22296;0;180;0;0;180
22297;0;0;0;0;0
22298;0;0;0;0;0
22299;0;0;0;0;0
22301;0;0;0;0;0
22302;0;0;0;0;0
22303;0;0;0;0;0
22304;0;0;0;0;0
22305;0;0;0;0;0
22306;144;420;90;0;654
22307;98;158;142;0;398
22308;23;405;45;0;473
22309;522;862;269;0;1653
22310;17;38;0;0;55
22311;0;0;0;0;0
22312;90;126;24;0;240
22313;52;525;97;0;674
22315;0;0;0;0;0
22316;0;0;0;0;0
22317;0;150;242;0;392
22318;67;20;0;0;87
22319;153;226;217;0;596
22320;65;315;45;0;425
22321;11;0;66;0;77
22322;69;436;235;0;740
22323;40;180;45;0;265
22324;0;0;0;0;0
22325;71;315;45;0;431
22326;0;0;0;0;0
22327;308;1387;360;0;2055
22329;0;0;0;0;0
22330;208;629;132;0;969
22332;0;0;0;0;0
22333;290;974;88;0;1352
22334;40;539;159;0;738
22335;0;0;0;0;0
22336;0;0;0;0;0
22337;84;293;87;0;464
22338;25;0;0;0;25
22339;0;535;90;0;625
22340;0;0;0;0;0
22341;0;0;0;0;0
22342;99;135;90;0;324
22343;40;437;112;0;589
22344;0;0;0;0;0
22346;25;0;45;0;70
22347;0;0;0;0;0
22348;0;0;45;0;45
22349;0;38;0;0;38
22350;0;0;0;0;0
22351;195;711;405;0;1311
22352;56;338;179;0;573
22353;0;44;0;0;44
22354;201;351;264;0;816
22355;65;395;195;0;655
22356;75;331;90;0;496
22357;0;0;0;0;0
22358;67;758;135;0;960
22360;0;0;0;0;0
22361;45;339;0;0;384
22363;79;247;45;0;371
22364;44;332;45;0;421
22365;0;0;0;0;0
22366;42;495;135;0;672
22367;0;45;45;0;90
22368;0;0;0;0;0
22369;0;0;0;0;0
22370;0;0;0;0;0
22371;0;0;0;0;0
22372;164;612;195;0;971
22373;0;0;23;0;23
22374;15;426;115;0;556
22375;2;209;45;0;256
22377;0;0;0;0;0
22378;0;0;0;0;0
22379;19;205;45;0;269
22380;247;1519;352;0;2118
22381;0;0;0;0;0
22382;25;203;45;0;273
22383;22;90;55;0;167
22384;0;0;0;0;0
22385;0;0;0;0;0
22386;0;0;0;0;0
22387;32;269;8;0;309
22388;89;88;62;0;239
22389;0;0;0;0;0
22390;35;270;67;0;372
22391;0;0;0;0;0
22392;0;0;0;0;0
22394;40;0;42;0;82
22395;0;0;0;0;0
22396;0;4;0;0;4
22397;0;135;90;0;225
22398;77;157;160;0;394
22399;0;0;0;0;0
22400;0;10;0;0;10
22401;25;40;30;0;95
22402;90;294;45;0;429
22403;138;337;176;0;651
22404;0;0;0;0;0
22405;0;110;40;0;150
22406;0;0;0;0;0
22407;0;0;0;0;0
22408;16;310;46;0;372
22410;0;827;270;0;1097
22411;0;0;0;0;0
22413;103;75;45;0;223
22414;179;1123;428;0;1730
22415;74;220;176;0;470
22416;0;0;0;0;0
22417;0;0;88;0;88
22418;686;1250;514;0;2450
22419;339;728;388;0;1455
22420;55;337;132;0;524
22421;23;132;44;0;199
22422;0;0;0;0;0
22423;0;0;0;0;0
22424;0;145;130;0;275
22425;70;44;108;0;222
22427;25;225;0;0;250
22428;132;839;256;0;1227
22429;0;60;40;0;100
22430;172;670;132;0;974
22431;0;0;0;0;0
22432;0;0;0;0;0
22433;84;165;45;0;294
22434;180;1755;675;0;2610
22435;0;0;0;0;0
22436;566;1785;396;0;2747
22437;0;0;0;0;0
22438;0;135;0;0;135
22439;82;416;180;0;678
22440;0;0;0;0;0
22441;0;0;0;0;0
22442;0;0;0;0;0
22444;65;352;66;0;483
22445;0;0;5;0;5
22446;30;35;45;0;110
22447;40;40;0;0;80
22448;0;0;0;0;0
22449;0;0;0;0;0
22450;0;0;0;0;0
22451;0;51;18;0;69
22452;0;234;38;0;272
22453;0;0;0;0;0
22454;0;0;0;0;0
22455;0;0;0;0;0
22456;0;201;155;0;356
22458;159;662;197;0;1018
22459;126;192;215;0;533
22461;45;45;90;0;180
22462;191;1105;269;0;1565
22463;0;0;0;0;0
22464;110;535;176;0;821
22465;0;0;0;0;0
22466;44;251;70;0;365
22467;0;113;77;0;190
22468;23;135;0;0;158
22469;0;0;0;0;0
22470;0;0;0;0;0
22471;0;0;102;0;102
22472;0;135;13;0;148
22473;45;21;21;0;87
22475;0;63;51;0;114
22476;13;964;242;0;1219
22477;0;0;0;0;0
22478;69;135;356;0;560
22479;0;329;45;0;374
22480;317;1112;440;0;1869
22481;0;0;0;0;0
22482;16;90;45;0;151
22483;88;352;359;0;799
22484;0;0;0;0;0
22485;20;0;64;0;84
22486;0;45;0;0;45
22487;38;429;135;0;602
22489;0;315;180;0;495
22490;0;0;0;0;0
22492;39;244;76;0;359
22493;132;526;176;0;834
22494;147;620;175;0;942
22495;58;258;110;0;426
22496;90;575;180;0;845
22497;0;0;0;0;0
22498;0;0;0;0;0
22499;145;810;540;0;1495
22500;0;0;0;0;0
22501;0;0;0;0;0
22502;0;0;0;0;0
22503;0;25;0;0;25
22504;269;651;0;0;920
22505;21;90;0;0;111
22506;0;0;0;0;0
22508;0;0;0;0;0
22509;144;668;392;0;1204
22511;0;0;0;0;0
22512;0;0;0;0;0
22513;0;0;0;0;0
22514;0;8;0;0;8
22515;0;0;0;0;0
22516;346;466;405;0;1217
22517;0;88;0;0;88
22518;0;0;0;0;0
22519;282;1216;308;0;1806
22520;14;45;40;0;99
22521;279;0;75;0;354
22522;0;95;0;0;95
22523;20;135;45;0;200
22525;0;90;35;0;125
22526;22;48;10;0;80
22527;250;1519;218;0;1987
22528;0;0;0;0;0
22529;72;540;65;0;677
22530;0;0;0;0;0
22531;176;429;180;0;785
22532;260;560;440;0;1260
22533;60;321;0;0;381
22534;0;0;0;0;0
22535;190;923;352;0;1465
22536;0;180;410;0;590
22537;0;0;4;0;4
22539;126;973;220;0;1319
22540;74;408;352;0;834
22542;154;248;225;0;627
22543;140;698;176;0;1014
22544;148;484;132;0;764
22545;72;322;11;0;405
22546;84;321;90;0;495
22547;47;135;30;0;212
22548;0;0;0;0;0
22549;0;44;45;0;89
22550;0;55;0;0;55
22551;0;90;45;0;135
22552;40;221;134;0;395
22553;263;1035;220;0;1518
22554;304;1118;558;0;1980
22556;0;38;10;0;48
22557;0;0;0;0;0
22558;150;598;176;0;924
22559;45;64;45;0;154
22560;513;1268;270;0;2051
22561;111;477;159;0;747
22562;0;0;0;0;0
22563;0;0;0;0;0
22564;56;335;270;0;661
22565;104;1035;180;0;1319
22566;25;315;113;0;453
22567;0;0;0;0;0
22568;0;0;0;0;0
22570;0;0;0;0;0
22571;133;351;20;0;504
22573;84;180;45;0;309
22574;25;205;45;0;275
22575;40;80;40;0;160
22576;0;0;0;0;0
22577;0;175;70;0;245
22578;76;135;45;0;256
22579;60;152;67;0;279
22580;11;0;85;0;96
22581;58;152;134;0;344
22582;0;0;0;0;0
22583;0;45;0;0;45
22584;0;8;40;0;48
22585;22;106;0;0;128
22587;0;0;0;0;0
22588;81;493;90;0;664
22589;0;0;0;0;0
22590;0;0;0;0;0
22591;0;40;45;0;85
22592;0;0;0;0;0
22593;29;135;0;0;164
22594;0;0;0;0;0
22595;0;25;0;0;25
22596;121;406;20;0;547
22597;130;198;177;0;505
22598;0;0;0;0;0
22599;145;45;134;0;324
22600;0;0;0;0;0
22601;0;74;0;0;74
22602;44;450;135;0;629
22603;0;107;65;0;172
22604;0;0;24;0;24
22606;28;98;45;0;171
22607;0;0;0;0;0
22608;45;225;135;0;405
22609;221;390;225;0;836
22610;107;405;180;0;692
22611;0;5;5;0;10
22612;160;431;44;0;635
22613;0;45;0;0;45
22614;22;220;115;0;357
22615;0;122;32;0;154
22616;0;234;45;0;279
22617;20;180;0;0;200
22618;67;209;160;0;436
22620;76;76;121;0;273
22621;98;373;105;0;576
22623;36;342;45;0;423
22624;0;0;40;0;40
22625;0;0;0;0;0
22626;80;220;132;0;432
22627;0;101;80;0;181
22628;0;241;45;0;286
22629;149;552;360;0;1061
22630;24;192;90;0;306
22631;0;0;0;0;0
22632;0;0;0;0;0
22633;0;90;0;0;90
22634;45;45;180;0;270
22635;0;0;0;0;0
22637;90;122;158;0;370
22638;0;124;0;0;124
22639;45;45;16;0;106
22640;0;0;0;0;0
22641;120;403;180;0;703
22642;0;0;0;0;0
22643;70;247;135;0;452
22644;0;0;0;0;0
22645;0;0;0;0;0
22646;0;59;22;0;81
22647;40;225;53;0;318
22648;32;155;75;0;262
22649;0;0;0;0;0
22650;8;119;45;0;172
22651;0;0;0;0;0
22652;0;0;0;0;0
22654;20;135;45;0;200
22655;220;381;220;0;821
22656;70;0;19;0;89
22657;66;180;65;0;311
22658;106;683;135;0;924
22659;0;0;0;0;0
22660;0;0;0;0;0
22661;39;315;67;0;421
22662;0;0;0;0;0
22663;0;400;135;0;535
22664;200;484;220;0;904
22665;12;88;28;0;128
22666;58;66;0;0;124
22668;0;45;45;0;90
22669;0;0;0;0;0
22671;23;150;25;0;198
22672;129;375;270;0;774
22673;0;0;0;0;0
22674;44;308;132;0;484
22675;0;0;0;0;0
22676;45;125;0;0;170
22677;16;225;90;0;331
22678;0;0;0;0;0
22679;0;55;0;0;55
22680;14;90;45;0;149
22681;0;0;0;0;0
22682;21;135;0;0;156
22683;0;45;0;0;45
22685;0;133;62;0;195
22686;371;583;352;0;1306
22687;48;114;23;0;185
22688;45;653;90;0;788
22689;0;0;0;0;0
22690;0;0;10;0;10
22691;66;484;264;0;814
22692;223;447;180;0;850
22693;0;0;0;0;0
22694;0;0;0;0;0
22695;0;0;0;0;0
22696;0;0;0;0;0
22697;0;90;45;0;135
22699;64;180;189;0;433
22700;0;252;30;0;282
22701;0;63;45;0;108
22702;550;578;135;0;1263
22704;112;180;312;0;604
22705;0;0;0;0;0
22706;60;88;44;0;192
22707;21;330;45;0;396
22708;20;0;45;0;65
22709;14;135;0;0;149
22710;79;179;22;0;280
22719;0;90;45;0;135
22736;94;225;45;0;364
22738;0;135;0;0;135
22739;32;280;115;0;427
22740;0;0;0;0;0
22741;25;151;90;0;266
22742;27;142;119;0;288
22743;45;180;90;0;315
22744;167;126;65;0;358
22745;22;0;0;0;22
22746;0;0;0;0;0
22747;48;313;90;0;451
22749;5;135;126;0;266
22750;0;0;0;0;0
22752;45;405;225;0;675
22753;0;90;0;0;90
22754;20;169;72;0;261
22755;275;586;352;0;1213
22756;0;60;25;0;85
22757;0;135;90;0;225
22758;298;1360;352;0;2010
22759;215;630;315;0;1160
22760;0;93;336;0;429
22761;0;96;0;0;96
22762;63;351;97;0;511
22763;0;52;42;0;94
22764;0;0;0;0;0
22766;94;374;45;0;513
24136;0;0;0;0;0
24200;0;0;0;0;0
24201;198;396;396;0;990
24202;0;0;0;0;0
24203;163;536;176;0;875
24204;14;220;132;0;366
24205;0;0;0;0;0
24206;38;1058;135;0;1231
24207;110;231;239;0;580
24209;194;458;309;0;961
24210;22;0;45;0;67
24212;284;429;360;0;1073
24213;267;393;217;0;877
24214;335;385;289;0;1009
24215;0;88;132;0;220
24216;690;790;528;0;2008
24217;0;0;0;0;0
24218;22;0;22;0;44
24219;0;0;0;0;0
24220;0;0;0;0;0
24221;0;0;0;0;0
24222;0;0;0;0;0
24223;68;225;145;0;438
24224;332;385;360;0;1077
24226;438;298;382;0;1118
24227;0;0;0;0;0
24228;0;0;0;0;0
24229;129;845;352;0;1326
24230;240;829;493;0;1562
24231;103;635;405;0;1143
24232;163;330;45;0;538
24233;53;357;155;0;565
24234;0;0;0;0;0
24235;0;0;0;0;0
24236;150;411;90;0;651
24237;0;80;45;0;125
24238;0;75;37;0;112
24240;0;220;396;0;616
24241;0;85;6;0;91
24243;149;220;70;0;439
24244;0;0;0;0;0
24248;0;44;0;0;44
24300;109;352;88;0;549
24301;0;0;0;0;0
24302;272;659;220;0;1151
24303;45;90;90;0;225
24305;155;857;630;0;1642
24307;472;1164;484;0;2120
24310;0;0;0;0;0
24311;158;159;205;0;522
24312;80;416;88;0;584
24313;249;680;264;0;1193
24314;0;0;0;0;0
24315;0;0;0;0;0
24316;691;350;440;0;1481
24317;410;690;220;0;1320
24318;242;838;220;0;1300
24319;30;290;177;0;497
24320;58;55;189;0;302
24321;287;624;30;0;941
24322;0;0;0;0;0
24324;0;159;64;0;223
24325;16;8;45;0;69
24327;276;697;450;0;1423
24328;0;0;0;0;0
24329;312;532;614;0;1458
24330;159;45;0;0;204
24331;200;82;40;0;322
24332;176;138;22;0;336
24333;30;122;0;0;152
24334;0;308;132;0;440
24335;109;320;80;0;509
24336;69;132;35;0;236
24338;166;998;199;0;1363
24339;107;307;45;0;459
24341;0;0;44;0;44
24342;45;176;28;0;249
24400;0;120;106;0;226
24401;256;354;539;0;1149
24402;0;0;0;0;0
24403;333;296;392;0;1021
24405;184;210;125;0;519
24406;45;0;90;0;135
24407;276;805;525;0;1606
24408;0;0;0;0;0
24409;472;659;270;0;1401
24410;90;531;440;0;1061
24411;0;0;0;0;0
24412;284;723;221;0;1228
24413;0;0;0;0;0
24414;0;0;0;0;0
24415;0;0;0;0;0
24419;0;0;0;0;0
24420;0;90;90;0;180
24422;0;0;0;0;0
24423;315;359;659;0;1333
24424;0;367;199;0;566
24425;0;0;0;0;0
24426;85;405;315;0;805
24427;197;715;360;0;1272
24428;86;156;90;0;332
24429;0;0;0;0;0
24430;69;45;303;0;417
24431;76;180;163;0;419
24432;0;0;0;0;0
24433;0;0;0;0;0
24434;0;0;0;0;0
24436;0;0;0;0;0
24437;0;0;0;0;0
24438;190;517;270;0;977
24439;0;0;0;0;0
24440;0;270;135;0;405
24441;0;0;0;0;0
24442;203;734;132;0;1069
24443;90;1096;528;0;1714
24444;132;638;315;0;1085
24445;169;510;352;0;1031
24446;171;438;622;0;1231
24447;0;0;0;0;0
24448;85;182;45;0;312
24450;0;0;0;0;0
24453;0;0;0;0;0
24454;0;0;0;0;0
24455;20;130;135;0;285
24456;0;0;0;0;0
24457;0;0;0;0;0
24458;0;0;0;0;0
24459;266;123;180;0;569
24460;0;0;0;0;0
24461;0;0;0;0;0
24462;0;90;0;0;90
24463;0;0;0;0;0
24464;161;884;353;0;1398
24465;0;0;0;0;0
24467;0;0;0;0;0
24468;0;0;0;0;0
24470;0;0;0;0;0
24471;0;0;0;0;0
24472;0;0;0;0;0
24473;294;221;220;0;735
24474;0;0;0;0;0
24476;0;0;0;0;0
24477;0;0;0;0;0
24479;0;0;0;0;0
24480;0;0;0;0;0
24481;0;0;0;0;0
24482;607;360;585;0;1552
24484;20;158;110;0;288
24485;0;0;0;0;0
24486;448;216;575;0;1239
24487;0;0;0;0;0
24488;0;0;0;0;0
24489;136;90;135;0;361
24490;0;0;0;0;0
24491;0;0;0;0;0
24492;0;0;0;0;0
24493;0;0;0;0;0
24494;0;0;0;0;0
24495;0;0;0;0;0
24496;70;206;89;0;365
24498;100;376;90;0;566
24499;6;0;135;0;141
24500;0;0;0;0;0
24501;0;0;0;0;0
24503;18;135;45;0;198
24505;0;0;0;0;0
24506;18;0;90;0;108
24507;0;0;0;0;0
24508;156;117;95;0;368
24509;0;0;0;0;0
24510;0;70;15;0;85
24511;0;0;0;0;0
24512;0;0;0;0;0
24517;0;0;0;0;0
24518;0;0;0;0;0
24519;0;0;0;0;0
24520;384;1074;528;0;1986
24521;0;0;0;0;0
24522;0;0;0;0;0
24523;0;0;0;0;0
24524;0;0;0;0;0
24525;0;0;0;0;0
24526;0;0;0;0;0
24539;0;0;0;0;0
24540;0;0;0;0;0
24542;0;0;0;0;0
24543;0;0;0;0;0
24544;0;0;0;0;0
24545;0;0;0;0;0
24546;0;0;0;0;0
24548;0;0;0;0;0
24549;0;0;0;0;0
24551;0;0;0;0;0
24553;0;0;0;0;0
24554;0;0;0;0;0
24556;0;0;0;0;0
24557;0;0;0;0;0
24558;290;674;296;0;1260
24559;0;0;0;0;0
24560;0;0;0;0;0
24561;0;0;0;0;0
24563;0;0;0;0;0
24565;0;0;0;0;0
24566;0;0;0;0;0
24567;0;0;0;0;0
24568;0;0;0;0;0
24569;0;0;0;0;0
24570;0;0;0;0;0
24571;0;0;0;0;0
24572;0;0;0;0;0
24573;0;0;0;0;0
24574;0;0;0;0;0
24575;0;0;0;0;0
24576;0;0;0;0;0
24577;0;0;0;0;0
24579;0;0;0;0;0
24580;0;0;0;0;0
24582;0;0;0;0;0
24583;0;0;0;0;0
24584;0;0;0;0;0
24585;0;0;0;0;0
24587;0;0;0;0;0
24590;0;0;0;0;0
24593;0;0;0;0;0
24594;0;0;0;0;0
24596;0;0;0;0;0
24597;0;0;0;0;0
24599;126;491;315;0;932
24601;0;45;90;0;135
24602;0;0;0;0;0
24603;0;0;0;0;0
24605;0;0;0;0;0
24607;0;0;0;0;0
24608;0;0;0;0;0
24609;0;0;0;0;0
24610;0;0;0;0;0
24611;0;0;0;0;0
24612;49;80;90;0;219
24613;0;0;0;0;0
24615;0;0;0;0;0
24616;0;45;0;0;45
24617;0;0;0;0;0
24618;0;0;0;0;0
24621;0;0;0;0;0
24622;514;1488;616;0;2618
24623;285;992;537;0;1814
24624;2154;503;625;0;3282
24625;60;494;225;0;779
24626;75;998;585;0;1658
24627;0;0;0;0;0
24629;0;0;0;0;0
24630;0;0;0;0;0
24632;0;0;0;0;0
24633;0;0;0;0;0
24634;0;0;0;0;0
24635;0;0;0;0;0
24636;0;0;0;0;0
24637;0;0;0;0;0
24638;74;616;308;0;998
24639;0;0;0;0;0
24640;0;0;0;0;0
24641;0;0;0;0;0
24642;219;246;450;0;915
24643;0;0;0;0;0
24644;0;0;0;0;0
24646;0;0;0;0;0
24647;0;0;0;0;0
24648;45;260;270;0;575
24649;25;159;179;0;363
24650;0;0;0;0;0
24651;0;0;0;0;0
24652;105;269;360;0;734
24653;0;0;0;0;0
24654;145;320;270;0;735
24655;0;0;0;0;0
24656;0;0;0;0;0
24657;59;295;135;0;489
24663;0;0;0;0;0
24664;0;0;0;0;0
24666;135;177;540;0;852
24667;0;0;0;0;0
24668;0;0;0;0;0
24670;0;0;0;0;0
24671;0;0;0;0;0
24672;0;0;0;0;0
24673;0;0;0;0;0
24674;0;0;0;0;0
24675;95;315;239;0;649
24677;0;0;0;0;0
24678;0;0;0;0;0
24679;0;0;0;0;0
24680;0;0;0;0;0
24681;0;0;0;0;0
24682;68;44;90;0;202
24684;51;215;154;0;420
24685;306;2465;1895;0;4666
24686;270;314;225;0;809
24687;0;0;0;0;0
24688;0;0;0;0;0
24689;150;361;254;0;765
24690;0;0;0;0;0
24691;0;0;0;0;0
24692;0;0;0;0;0
24694;0;0;0;0;0
24695;0;0;0;0;0
24696;0;0;0;0;0
24697;0;0;0;0;0
24698;0;0;0;0;0
24699;296;85;315;0;696
24700;0;83;0;0;83
24701;0;0;0;0;0
24702;0;0;0;0;0
24703;0;0;0;0;0
24704;0;0;0;0;0
24705;0;90;90;0;180
24706;0;0;0;0;0
24707;0;135;45;0;180
24708;0;0;0;0;0
24711;0;0;0;0;0
24713;135;767;450;0;1352
24714;256;596;450;0;1302
24715;105;268;358;0;731
24716;263;465;810;0;1538
24717;178;647;474;0;1299
24718;0;0;0;0;0
24719;33;328;110;0;471
24720;0;0;0;0;0
24721;511;458;374;0;1343
24722;122;550;179;0;851
24723;0;0;0;0;0
24724;0;0;0;0;0
24725;0;0;0;0;0
24727;0;0;0;0;0
24729;0;0;0;0;0
24730;53;662;263;0;978
24732;0;90;90;0;180
24733;175;1189;855;0;2219
24734;0;0;0;0;0
24735;0;0;0;0;0
24736;0;25;0;0;25
24737;0;70;0;0;70
24738;69;0;295;0;364
24739;0;0;0;0;0
24740;0;0;0;0;0
24741;0;0;0;0;0
24742;86;135;80;0;301
24744;0;0;0;0;0
24745;0;0;0;0;0
24748;0;0;0;0;0
24749;0;0;0;0;0
24750;89;45;90;0;224
24751;189;440;352;0;981
24752;0;124;40;0;164
24753;0;0;0;0;0
24754;56;132;220;0;408
24755;45;90;98;0;233
24756;330;449;585;0;1364
24758;91;292;210;0;593
24759;144;568;405;0;1117
24761;0;0;0;0;0
24762;0;0;0;0;0
24763;25;10;0;0;35
24764;0;0;0;0;0
24765;0;88;15;0;103
24766;130;180;90;0;400
24767;0;662;360;0;1022
24768;0;0;0;0;0
24769;227;663;330;0;1220
24770;0;0;0;0;0
24771;0;0;0;0;0
24772;0;0;0;0;0
24773;0;0;0;0;0
24775;0;0;0;0;0
24777;0;0;0;0;0
24778;0;0;0;0;0
24779;0;0;0;0;0
24780;0;0;0;0;0
24781;0;0;0;0;0
24782;60;135;270;0;465
24783;0;0;0;0;0
24784;0;0;0;0;0
24785;0;0;0;0;0
24786;0;0;0;0;0
24787;0;0;0;0;0
24789;45;495;180;0;720
24790;143;95;160;0;398
24794;0;0;0;0;0
24795;0;0;0;0;0
24796;0;0;0;0;0
24797;0;0;0;0;0
24798;0;0;0;0;0
24799;0;0;0;0;0
24800;80;300;225;0;605
24801;0;0;0;0;0
24802;0;0;0;0;0
24803;10;167;175;0;352
24804;429;606;176;0;1211
24805;0;0;0;0;0
24806;0;0;0;0;0
24808;0;0;0;0;0
24809;98;395;321;0;814
24811;0;0;0;0;0
24812;74;804;390;0;1268
24813;0;0;0;0;0
24814;0;0;0;0;0
24815;0;0;0;0;0
24816;0;0;0;0;0
24817;354;89;252;0;695
24818;0;0;0;0;0
24819;0;0;0;0;0
24820;0;0;0;0;0
24821;0;0;0;0;0
24822;337;390;336;0;1063
24823;0;0;0;0;0
24825;0;0;0;0;0
24826;45;0;0;0;45
24827;0;0;0;0;0
24828;64;472;207;0;743
24829;0;0;0;0;0
24830;0;0;0;0;0
24831;0;0;0;0;0
24832;0;0;0;0;0
24834;0;0;0;0;0
24835;0;0;0;0;0
24836;338;448;266;0;1052
24837;0;0;0;0;0
24839;0;0;0;0;0
24840;90;90;45;0;225
24842;0;0;0;0;0
24843;413;728;625;0;1766
24844;0;0;0;0;0
24845;0;0;0;0;0
24846;0;0;0;0;0
24847;0;0;0;0;0
24848;0;0;0;0;0
24849;0;0;0;0;0
24850;0;0;0;0;0
24851;0;0;0;0;0
24852;0;0;0;0;0
24853;0;0;0;0;0
24854;92;94;110;0;296
24856;279;633;220;0;1132
24857;0;0;0;0;0
24858;0;0;0;0;0
24859;0;0;0;0;0
24860;0;0;0;0;0
24861;0;0;0;0;0
24862;0;0;0;0;0
24863;0;0;0;0;0
24864;302;416;45;0;763
24865;0;0;0;0;0
24866;415;673;543;0;1631
24867;0;0;0;0;0
24868;54;225;161;0;440
24870;0;0;0;0;0
24871;0;0;0;0;0
24873;0;0;0;0;0
24874;0;0;0;0;0
24875;32;90;90;0;212
24876;715;808;440;0;1963
24877;0;0;0;0;0
24878;330;2360;1095;0;3785
24879;118;285;383;0;786
24880;48;248;45;0;341
24881;148;193;88;0;429
24882;93;360;90;0;543
24883;253;551;264;0;1068
24884;916;360;765;0;2041
24885;192;864;45;0;1101
24888;0;0;0;0;0
24889;696;1220;629;0;2545
24890;0;0;0;0;0
24891;0;0;0;0;0
24892;157;510;90;0;757
24893;174;150;160;0;484
24894;0;418;156;0;574
24895;0;0;0;0;0
24896;0;44;45;0;89
24897;0;0;0;0;0
24898;0;68;90;0;158
24900;106;132;45;0;283
24901;0;0;0;0;0
24902;0;0;0;0;0
24903;0;90;45;0;135
24904;0;0;0;0;0
24906;0;0;0;0;0
24907;307;44;0;0;351
24908;75;0;0;0;75
24909;0;0;0;0;0
24910;0;0;0;0;0
24911;0;80;40;0;120
24912;0;0;0;0;0
24913;93;245;90;0;428
24914;0;0;0;0;0
24915;0;0;0;0;0
24916;0;30;45;0;75
24917;0;0;0;0;0
24918;0;0;0;0;0
24920;35;90;90;0;215
24921;0;0;0;0;0
24923;0;0;0;0;0
24924;72;135;135;0;342
24925;0;0;0;0;0
24926;81;87;135;0;303
24927;0;0;0;0;0
24928;0;0;0;0;0
24929;0;0;0;0;0
24930;154;543;375;0;1072
24931;60;0;45;0;105
24932;24;0;133;0;157
24933;0;112;0;0;112
24934;0;0;0;0;0
24935;217;435;270;0;922
24937;5;42;0;0;47
24938;0;0;0;0;0
24939;75;220;90;0;385
24940;0;0;0;0;0
24941;0;0;0;0;0
24942;16;42;60;0;118
24943;0;0;0;0;0
24944;128;400;0;0;528
24945;45;180;270;0;495
24946;197;4759;285;0;5241
24947;0;0;0;0;0
24948;0;0;0;0;0
24950;0;0;0;0;0
24952;38;135;45;0;218
24954;34;408;136;0;578
24955;0;0;0;0;0
24956;193;235;540;0;968
24957;110;360;90;0;560
24958;0;0;0;0;0
24959;214;572;88;0;874
24960;0;240;40;0;280
24961;111;135;23;0;269
24963;246;828;180;0;1254
24964;0;0;0;0;0
24966;16;130;270;0;416
24968;62;88;89;0;239
24969;0;237;90;0;327
24971;0;0;0;0;0
24972;45;1261;270;0;1576
24973;0;0;0;0;0
24974;0;0;0;0;0
24976;299;970;315;0;1584
24977;0;0;0;0;0
24978;576;1344;765;0;2685
24979;60;258;675;0;993
24980;92;417;90;0;599
24981;0;0;0;0;0
24982;0;0;0;0;0
24983;0;0;0;0;0
24985;45;45;0;0;90
24986;0;0;0;0;0
24987;265;748;176;0;1189
24988;311;488;359;0;1158
24989;11;313;180;0;504
24990;0;0;0;0;0
24992;0;0;0;0;0
24994;0;0;0;0;0
24995;15;230;220;0;465
24997;299;442;286;0;1027
24999;748;748;572;0;2068
25001;0;809;45;0;854
25002;44;1449;44;0;1537
25003;0;0;0;0;0
25005;40;312;180;0;532
25006;0;0;0;0;0
25007;0;0;0;0;0
25009;220;449;390;0;1059
25011;0;0;0;0;0
25012;180;965;540;0;1685
25013;0;0;0;0;0
25014;110;517;220;0;847
25015;51;300;140;0;491
25016;96;345;180;0;621
25017;73;165;90;0;328
25019;0;44;20;0;64
25020;30;170;45;0;245
25022;24;66;180;0;270
25023;0;0;0;0;0
25025;128;709;439;0;1276
25026;90;370;225;0;685
25027;90;165;180;0;435
25028;391;819;327;0;1537
25029;0;0;0;0;0
25030;8;45;0;0;53
25031;0;212;74;0;286
25032;127;1779;584;0;2490
25034;0;45;0;0;45
25036;32;229;45;0;306
25037;0;0;0;0;0
25038;30;254;90;0;374
25039;120;360;135;0;615
25040;0;0;0;0;0
25041;104;572;450;0;1126
25042;458;688;488;0;1634
25043;45;1190;160;0;1395
25044;0;0;0;0;0
25045;0;0;0;0;0
25046;24;88;128;0;240
25047;392;1155;486;0;2033
25048;63;477;158;0;698
25050;66;386;430;0;882
25051;0;0;0;0;0
25053;0;0;0;0;0
25054;0;0;0;0;0
25055;392;804;945;0;2141
25056;0;0;0;0;0
25057;0;0;0;0;0
25058;0;0;0;0;0
25059;230;405;585;0;1220
25061;151;142;360;0;653
25062;0;70;225;0;295
25063;0;0;0;0;0
25065;625;1804;0;0;2429
25067;0;0;0;0;0
25068;0;0;0;0;0
25069;0;0;0;0;0
25070;75;655;180;0;910
25071;135;416;225;0;776
25073;0;88;45;0;133
25074;0;0;0;0;0
25075;49;127;90;0;266
25076;0;0;0;0;0
25077;0;0;0;0;0
25078;276;856;405;0;1537
25079;75;70;133;0;278
25080;50;359;27;0;436
25081;0;0;0;0;0
25082;208;539;405;0;1152
25084;40;275;269;0;584
25085;31;45;90;0;166
25086;0;0;0;0;0
25087;15;137;45;0;197
25089;274;698;672;0;1644
25090;0;0;0;0;0
25091;213;1734;1215;0;3162
25092;65;67;135;0;267
25093;0;0;0;0;0
25094;442;696;270;0;1408
25095;0;45;90;0;135
25096;0;0;0;0;0
25098;90;135;90;0;315
25099;0;0;44;0;44
25100;0;0;0;0;0
25101;676;1036;675;0;2387
25103;72;203;69;0;344
25104;0;0;0;0;0
25105;0;0;0;0;0
25106;0;0;0;0;0
25107;30;0;475;0;505
25108;0;0;0;0;0
25109;40;318;105;0;463
25110;0;0;0;0;0
25111;0;0;0;0;0
25112;53;45;45;0;143
25113;0;0;0;0;0
25114;317;1162;360;0;1839
25115;31;88;118;0;237
25117;132;311;90;0;533
25118;48;180;145;0;373
25119;76;360;205;0;641
25120;0;0;0;0;0
25121;40;1105;765;0;1910
25122;0;0;0;0;0
25123;0;0;0;0;0
25124;0;0;0;0;0
25125;25;190;45;0;260
25126;0;0;0;0;0
25127;0;0;0;0;0
25128;0;0;0;0;0
25129;113;0;45;0;158
25130;0;167;30;0;197
25131;61;483;124;0;668
25132;35;396;270;0;701
25134;45;540;135;0;720
25135;0;0;0;0;0
25136;45;444;0;0;489
25137;0;0;0;0;0
25138;85;225;157;0;467
25139;0;0;0;0;0
25140;0;0;0;0;0
25142;0;0;0;0;0
25143;135;512;32;0;679
25145;0;90;45;0;135
25146;0;0;0;0;0
25148;0;30;45;0;75
25149;0;0;0;0;0
25151;0;0;0;0;0
25152;0;0;0;0;0
25153;476;1043;746;0;2265
25154;77;180;45;0;302
25155;149;208;148;0;505
25156;0;0;0;0;0
25157;510;1570;450;0;2530
25158;8;90;29;0;127
25159;0;0;0;0;0
25160;120;45;135;0;300
25161;0;0;0;0;0
25162;183;249;90;0;522
25163;0;0;0;0;0
25165;0;0;0;0;0
25166;560;780;327;0;1667
25167;0;0;0;0;0
25169;8;124;73;0;205
25170;37;216;45;0;298
25171;78;479;135;0;692
25172;173;731;90;0;994
25173;235;104;132;0;471
25174;0;0;0;0;0
25175;0;90;0;0;90
25176;0;0;0;0;0
25177;0;0;0;0;0
25179;40;225;45;0;310
25180;0;0;0;0;0
25182;128;230;308;0;666
25183;0;0;0;0;0
25184;0;0;0;0;0
25185;195;637;225;0;1057
25186;626;297;310;0;1233
25187;36;169;90;0;295
25188;72;328;423;0;823
25189;98;159;45;0;302
25190;0;0;0;0;0
25191;94;406;45;0;545
25192;166;591;135;0;892
25193;0;0;0;0;0
25194;216;432;220;0;868
25196;95;374;306;0;775
25197;50;444;225;0;719
25198;54;862;495;0;1411
25199;104;0;282;0;386
25201;207;528;90;0;825
25202;355;765;225;0;1345
25203;24;0;135;0;159
25204;0;35;0;0;35
25205;0;0;0;0;0
25206;75;51;157;0;283
25207;0;0;0;0;0
25208;64;90;112;0;266
25209;39;0;39;0;78
25210;0;111;38;0;149
25211;0;0;45;0;45
25212;0;20;0;0;20
25213;0;0;0;0;0
25215;289;630;415;0;1334
25216;107;584;72;0;763
25217;70;30;57;0;157
25218;382;428;400;0;1210
25219;18;93;44;0;155
25220;419;720;294;0;1433
25221;314;137;215;0;666
25222;61;226;110;0;397
25223;521;388;255;0;1164
25224;0;0;0;0;0
25225;209;240;297;0;746
25226;46;88;20;0;154
25227;55;347;169;0;571
25230;65;135;240;0;440
25232;18;88;45;0;151
25233;0;0;0;0;0
25234;0;0;0;0;0
25235;14;176;148;0;338
25236;35;114;45;0;194
25237;240;180;45;0;465
25238;134;432;747;0;1313
25239;0;0;0;0;0
25240;0;0;0;0;0
25241;0;0;0;0;0
25242;0;0;0;0;0
25243;0;0;0;0;0
25244;0;268;134;0;402
25246;0;0;0;0;0
25247;190;44;88;0;322
25249;45;481;900;0;1426
25250;329;623;810;0;1762
25251;0;0;0;0;0
25252;0;0;0;0;0
25253;0;0;0;0;0
25254;0;0;0;0;0
25255;97;585;315;0;997
25256;76;814;315;0;1205
25257;45;0;0;0;45
25258;45;195;90;0;330
25260;148;140;555;0;843
25261;0;84;15;0;99
25263;69;274;135;0;478
25264;50;0;80;0;130
25265;197;474;225;0;896
25266;0;0;0;0;0
25267;0;0;0;0;0
25269;93;317;289;0;699
25270;0;20;45;0;65
25271;0;208;178;0;386
25272;24;109;65;0;198
25273;136;180;45;0;361
25274;0;0;0;0;0
25275;45;180;45;0;270
25277;233;484;132;0;849
25278;0;0;0;0;0
25279;67;405;90;0;562
25280;90;45;45;0;180
25281;25;140;45;0;210
25282;419;765;866;0;2050
25283;38;0;90;0;128
25284;32;128;45;0;205
25285;0;0;0;0;0
25286;32;132;70;0;234
25287;60;135;135;0;330
25288;146;387;360;0;893
25289;48;315;200;0;563
25290;25;74;30;0;129
25291;0;0;0;0;0
25292;0;0;0;0;0
25294;24;0;225;0;249
25295;0;0;0;0;0
25296;36;210;82;0;328
25297;34;170;135;0;339
25298;20;44;149;0;213
25299;0;0;0;0;0
25300;95;180;180;0;455
25301;46;225;180;0;451
25302;16;90;37;0;143
25303;60;244;206;0;510
25304;180;875;550;0;1605
25305;0;119;45;0;164
25306;98;45;90;0;233
25307;46;270;90;0;406
25308;0;0;0;0;0
25310;703;688;270;0;1661
25311;0;0;0;0;0
25314;540;296;220;0;1056
25315;293;572;176;0;1041
25316;229;306;207;0;742
25317;34;106;112;0;252
25318;0;0;0;0;0
25319;209;609;450;0;1268
25320;17;65;80;0;162
25321;0;0;0;0;0
25322;38;50;20;0;108
25323;0;0;0;0;0
25324;639;765;315;0;1719
25325;0;0;0;0;0
25327;22;112;82;0;216
25328;70;205;225;0;500
25329;695;530;1575;0;2800
25330;85;0;0;0;85
25331;67;619;270;0;956
25332;145;45;300;0;490
25333;24;0;208;0;232
25334;112;135;155;0;402
25335;0;0;0;0;0
25336;0;0;0;0;0
25337;0;0;0;0;0
25338;0;0;0;0;0
25339;10;90;30;0;130
25340;0;0;0;0;0
25341;0;0;0;0;0
25342;110;727;466;0;1303
25344;0;74;0;0;74
25346;0;0;180;0;180
25347;90;405;225;0;720
25348;268;1844;945;0;3057
25349;90;909;495;0;1494
25350;108;175;401;0;684
25351;89;45;136;0;270
25352;210;1136;346;0;1692
25353;116;157;135;0;408
25354;60;200;315;0;575
25355;44;70;8;0;122
25356;18;212;250;0;480
25358;29;174;30;0;233
25359;229;151;85;0;465
25361;55;179;90;0;324
25362;111;45;135;0;291
25363;72;315;90;0;477
25364;38;88;0;0;126
25365;52;83;90;0;225
25366;0;0;0;0;0
25367;82;504;315;0;901
25368;384;737;1122;0;2243
25369;624;1948;1135;0;3707
25370;85;135;225;0;445
25371;574;1193;629;0;2396
25372;0;0;0;0;0
25373;28;133;44;0;205
25375;50;89;248;0;387
25376;24;90;135;0;249
25377;12;175;135;0;322
25378;0;0;0;0;0
25379;0;0;0;0;0
25380;0;0;0;0;0
25381;32;122;224;0;378
25382;325;303;270;0;898
25383;25;147;45;0;217
25384;59;225;405;0;689
25385;45;225;0;0;270
25386;338;815;435;0;1588
25387;355;1471;470;0;2296
25389;242;405;450;0;1097
25390;10;124;155;0;289
25392;78;145;135;0;358
25393;110;205;45;0;360
25394;12;35;44;0;91
25395;580;1164;641;0;2385
25396;539;1707;765;0;3011
25397;51;180;45;0;276
25398;98;855;198;0;1151
25399;45;270;0;0;315
25400;85;45;225;0;355
25401;0;0;0;0;0
25402;325;273;585;0;1183
25403;40;171;135;0;346
25404;69;135;45;0;249
25405;55;0;209;0;264
25406;80;44;105;0;229
25408;32;75;45;0;152
25409;0;0;0;0;0
25411;0;0;0;0;0
25412;0;0;0;0;0
25413;35;447;135;0;617
25414;42;224;78;0;344
25415;36;112;90;0;238
25416;0;0;0;0;0
25417;63;104;135;0;302
25418;378;932;710;0;2020
25419;0;0;0;0;0
25420;26;90;45;0;161
25421;63;45;180;0;288
25422;0;0;0;0;0
25423;124;90;135;0;349
25425;66;268;288;0;622
25426;29;132;45;0;206
25427;77;184;132;0;393
25428;28;159;90;0;277
25429;17;90;45;0;152
25430;30;70;45;0;145
25431;67;385;90;0;542
25432;0;0;0;0;0
25433;25;104;45;0;174
25434;90;207;90;0;387
25435;0;0;0;0;0
25436;53;586;308;0;947
25437;29;67;94;0;190
25439;142;1265;870;0;2277
25440;24;90;225;0;339
25442;45;270;180;0;495
25443;0;236;45;0;281
25444;0;0;0;0;0
25445;0;0;0;0;0
25446;0;30;30;0;60
25447;0;225;180;0;405
25448;355;2577;630;0;3562
25449;0;0;0;0;0
25450;225;315;90;0;630
25451;40;114;45;0;199
25452;174;371;483;0;1028
25453;0;0;0;0;0
25454;147;253;149;0;549
25456;0;0;0;0;0
25457;0;0;0;0;0
25458;83;315;180;0;578
25459;64;135;225;0;424
25460;17;25;45;0;87
25461;68;132;0;0;200
25462;338;519;405;0;1262
25463;157;45;135;0;337
25464;540;816;799;0;2155
25465;70;322;255;0;647
25466;51;133;0;0;184
25467;85;210;135;0;430
25468;0;0;0;0;0
25470;8;132;61;0;201
25471;18;225;90;0;333
25473;0;53;67;0;120
25474;0;0;0;0;0
25475;389;600;565;0;1554
25476;0;0;0;0;0
25477;135;40;0;0;175
25478;0;0;0;0;0
25479;0;0;0;0;0
25480;45;348;90;0;483
25481;268;535;360;0;1163
25482;90;231;90;0;411
25483;0;0;0;0;0
25484;97;273;225;0;595
25485;8;525;45;0;578
25487;272;675;180;0;1127
25488;0;0;0;0;0
25489;48;599;580;0;1227
25490;44;22;179;0;245
25491;0;0;0;0;0
25492;45;115;86;0;246
25494;0;0;0;0;0
25495;0;0;0;0;0
25496;1060;450;498;0;2008
25497;0;0;0;0;0
25498;0;0;0;0;0
25499;0;0;0;0;0
25500;42;225;135;0;402
25501;566;669;315;0;1550
25502;0;45;42;0;87
25503;0;65;20;0;85
25504;0;71;40;0;111
25505;0;0;0;0;0
25506;27;165;90;0;282
25507;70;90;165;0;325
25508;30;498;180;0;708
25509;186;468;765;0;1419
25510;63;263;60;0;386
25511;0;180;90;0;270
25512;0;0;0;0;0
25513;24;200;45;0;269
25514;30;177;88;0;295
25515;0;0;0;0;0
25516;93;360;355;0;808
25517;92;135;90;0;317
25518;0;0;0;0;0
25520;505;180;440;0;1125
25521;0;0;0;0;0
25523;548;858;1065;0;2471
25524;0;61;0;0;61
25525;79;323;90;0;492
25526;135;538;169;0;842
25527;61;282;135;0;478
25528;99;358;45;0;502
25529;17;165;45;0;227
25530;0;204;90;0;294
25531;0;0;0;0;0
25532;45;93;179;0;317
25533;19;387;45;0;451
25534;50;135;45;0;230
25535;0;0;0;0;0
25537;66;45;343;0;454
25538;0;0;0;0;0
25539;310;382;214;0;906
25540;452;1214;684;0;2350
25541;0;290;250;0;540
25542;535;1170;360;0;2065
25543;71;180;90;0;341
25544;174;495;135;0;804
25545;24;155;15;0;194
25546;63;158;335;0;556
25547;32;135;90;0;257
25548;0;0;0;0;0
25549;0;0;0;0;0
25550;148;994;645;0;1787
25551;64;80;45;0;189
25552;0;0;0;0;0
25554;162;675;830;0;1667
25555;22;70;80;0;172
25556;218;495;245;0;958
25557;35;326;180;0;541
25558;177;655;173;0;1005
25559;0;0;0;0;0
25560;60;180;45;0;285
25561;37;205;225;0;467
25562;260;1025;505;0;1790
25563;40;130;40;0;210
25564;48;405;90;0;543
25565;72;90;135;0;297
25566;16;137;44;0;197
25568;71;160;49;0;280
25569;77;0;180;0;257
25571;105;728;495;0;1328
25572;81;210;135;0;426
25573;105;109;405;0;619
25574;149;90;135;0;374
25575;21;90;90;0;201
25576;134;516;360;0;1010
25577;101;135;208;0;444
25578;0;0;0;0;0
25579;0;0;0;0;0
25580;115;588;270;0;973
25581;88;221;134;0;443
25582;86;270;135;0;491
25583;61;25;90;0;176
25585;90;190;312;0;592
25586;25;122;114;0;261
25587;0;0;0;0;0
25588;0;0;0;0;0
25589;272;875;450;0;1597
25590;0;0;0;0;0
25591;410;800;669;0;1879
25592;106;132;165;0;403
25593;0;268;135;0;403
25594;24;135;180;0;339
25595;96;225;45;0;366
25596;64;0;180;0;244
25597;0;0;0;0;0
25599;180;755;270;0;1205
25600;0;0;0;0;0
25601;19;85;40;0;144
25602;90;44;155;0;289
25604;85;283;233;0;601
25605;0;0;0;0;0
25606;0;0;0;0;0
25607;0;32;25;0;57
25608;24;45;177;0;246
25609;25;25;135;0;185
25610;28;180;35;0;243
25611;0;0;0;0;0
25612;113;607;110;0;830
25613;371;1265;390;0;2026
25614;30;88;44;0;162
25615;220;475;180;0;875
25616;10;44;55;0;109
25618;16;8;90;0;114
25619;0;0;0;0;0
25621;23;0;135;0;158
25622;22;181;45;0;248
25623;0;0;0;0;0
25624;252;439;135;0;826
25625;70;166;187;0;423
25626;0;0;0;0;0
25627;16;480;0;0;496
25628;0;0;0;0;0
25629;36;0;38;0;74
25630;357;260;220;0;837
25631;28;202;20;0;250
25632;29;90;70;0;189
25633;0;45;57;0;102
25635;0;0;0;0;0
25636;38;250;135;0;423
25637;0;0;0;0;0
25638;20;22;202;0;244
25639;314;90;715;0;1119
25640;315;493;0;0;808
25641;50;120;45;0;215
25642;75;344;264;0;683
25643;0;0;0;0;0
25644;340;89;360;0;789
25645;218;1214;405;0;1837
25646;80;45;45;0;170
25647;99;31;274;0;404
25649;30;135;45;0;210
25650;135;2372;990;0;3497
25652;30;0;0;0;30
25653;0;0;0;0;0
25654;0;0;0;0;0
25655;113;592;315;0;1020
25656;32;132;176;0;340
25657;0;0;0;0;0
25658;60;216;90;0;366
25659;0;0;0;0;0
25660;0;0;0;0;0
25661;0;0;70;0;70
25662;0;0;0;0;0
25663;0;0;0;0;0
25664;60;405;90;0;555
25666;0;0;0;0;0
25667;32;135;90;0;257
25668;9;142;67;0;218
25669;266;132;396;0;794
25670;0;0;45;0;45
25671;145;0;90;0;235
25672;0;0;0;0;0
25673;0;0;0;0;0
25674;55;167;70;0;292
25675;138;1207;580;0;1925
25676;272;481;720;0;1473
25677;0;0;0;0;0
25678;0;0;0;0;0
25680;0;0;0;0;0
25681;30;269;125;0;424
25683;74;8;143;0;225
25684;0;0;0;0;0
25685;0;0;0;0;0
25686;0;0;0;0;0
25687;0;0;0;0;0
25688;135;12;434;0;581
25689;0;0;0;0;0
25690;0;0;0;0;0
25691;0;0;0;0;0
25692;55;45;394;0;494
25693;0;684;201;0;885
25694;0;0;0;0;0
25695;45;995;522;0;1562
25697;278;45;225;0;548
25698;204;1049;450;0;1703
25699;0;0;0;0;0
25700;89;658;315;0;1062
25702;0;0;0;0;0
25703;154;819;225;0;1198
25704;197;1028;315;0;1540
25705;67;135;45;0;247
25707;0;0;0;0;0
25708;0;0;0;0;0
25709;168;1019;250;0;1437
25710;32;117;45;0;194
25711;192;1038;308;0;1538
25712;405;128;68;0;601
25713;90;232;400;0;722
25714;45;390;180;0;615
25716;0;1038;450;0;1488
25717;278;1294;545;0;2117
25718;135;45;75;0;255
25719;0;85;0;0;85
25720;0;0;0;0;0
25721;0;0;0;0;0
25722;120;520;461;0;1101
25723;60;60;0;0;120
25724;75;810;360;0;1245
25725;115;225;360;0;700
25726;72;442;170;0;684
25727;628;489;695;0;1812
25728;0;0;0;0;0
25730;0;0;0;0;0
25731;0;38;0;0;38
25733;190;1615;465;0;2270
25734;0;0;0;0;0
25735;40;105;135;0;280
25736;0;90;130;0;220
25737;155;540;225;0;920
25738;0;136;170;0;306
25739;154;657;403;0;1214
25740;76;270;90;0;436
25741;80;180;45;0;305
25742;0;127;102;0;229
25743;14;88;0;0;102
25744;0;0;0;0;0
25745;0;0;0;0;0
25747;12;77;323;0;412
25748;0;45;0;0;45
25749;10;3175;405;0;3590
25750;24;225;45;0;294
25751;403;302;540;0;1245
25752;48;70;135;0;253
25753;40;0;60;0;100
25754;64;0;120;0;184
25755;0;0;0;0;0
25756;2;153;45;0;200
25757;24;180;130;0;334
25758;0;0;0;0;0
25760;0;0;0;0;0
25761;0;0;0;0;0
25762;0;0;0;0;0
25764;135;319;45;0;499
25765;74;165;90;0;329
25766;376;1028;585;0;1989
25767;210;125;180;0;515
25768;0;0;0;0;0
25769;0;0;0;0;0
25770;257;528;487;0;1272
25771;0;0;0;0;0
25772;0;0;70;0;70
25773;109;135;39;0;283
25774;32;225;135;0;392
25775;0;63;45;0;108
25776;0;0;90;0;90
25778;0;0;0;0;0
25779;589;1215;765;0;2569
25781;312;643;1143;0;2098
25782;44;44;44;0;132
25783;283;499;270;0;1052
25784;30;45;205;0;280
25785;75;427;192;0;694
25786;115;360;90;0;565
25787;24;180;90;0;294
25788;286;812;440;0;1538
25789;0;0;0;0;0
25790;109;507;224;0;840
25791;121;134;90;0;345
25792;0;310;45;0;355
25793;16;202;0;0;218
25795;0;135;150;0;285
25796;0;0;0;0;0
25797;137;196;264;0;597
25798;120;376;90;0;586
25799;95;160;190;0;445
25800;0;0;0;0;0
25801;125;515;135;0;775
25802;0;0;0;0;0
25803;116;223;310;0;649
25804;20;967;270;0;1257
25805;0;0;0;0;0
25806;0;0;0;0;0
25807;24;286;45;0;355
25808;0;179;45;0;224
25809;16;90;45;0;151
25810;0;0;0;0;0
25811;0;0;0;0;0
25812;0;30;30;0;60
25814;120;234;340;0;694
25816;0;0;0;0;0
25817;0;0;0;0;0
25818;200;160;135;0;495
25819;14;65;60;0;139
25820;0;0;0;0;0
25821;0;0;0;0;0
25822;0;270;0;0;270
25823;44;88;132;0;264
25824;35;645;495;0;1175
25825;264;202;270;0;736
25826;48;167;45;0;260
25828;36;186;85;0;307
25829;207;656;315;0;1178
25831;39;98;85;0;222
25832;44;185;180;0;409
25833;0;0;0;0;0
25834;99;264;45;0;408
25835;0;0;0;0;0
25836;0;70;165;0;235
25837;0;0;0;0;0
25838;150;229;180;0;559
25839;125;157;70;0;352
25840;0;22;0;0;22
25841;0;0;0;0;0
25842;91;559;162;0;812
25843;150;701;450;0;1301
25845;165;65;301;0;531
25846;0;0;0;0;0
25847;93;0;360;0;453
25848;0;0;0;0;0
25849;0;0;0;0;0
25850;90;540;90;0;720
25851;0;120;190;0;310
25852;176;389;288;0;853
25853;210;514;405;0;1129
25854;0;229;90;0;319
25855;224;441;360;0;1025
25856;17;90;45;0;152
25857;50;0;89;0;139
25859;21;90;135;0;246
25860;76;472;154;0;702
25862;155;517;270;0;942
25863;0;0;0;0;0
25864;0;0;0;0;0
25865;279;624;345;0;1248
25866;0;0;0;0;0
25867;64;225;90;0;379
25868;0;0;0;0;0
25869;71;90;90;0;251
25870;0;0;0;0;0
25871;0;0;0;0;0
25872;8;45;25;0;78
25873;0;401;45;0;446
25874;0;60;20;0;80
25876;198;42;185;0;425
25877;56;135;225;0;416
25878;72;88;132;0;292
25879;0;0;0;0;0
25880;0;0;0;0;0
25881;100;45;315;0;460
25882;40;1080;567;0;1687
25883;56;225;90;0;371
25884;126;145;240;0;511
25885;90;890;450;0;1430
25886;44;182;89;0;315
25887;8;216;90;0;314
25890;146;360;25;0;531
25891;0;0;0;0;0
25893;0;0;0;0;0
25894;74;360;132;0;566
25895;405;180;405;0;990
25896;0;0;0;0;0
25897;20;229;90;0;339
25898;0;0;0;0;0
25899;89;259;297;0;645
25900;42;0;90;0;132
25901;272;528;268;0;1068
25902;16;88;64;0;168
25903;74;90;45;0;209
25904;100;270;135;0;505
25905;0;0;90;0;90
25906;24;112;44;0;180
25907;90;43;90;0;223
25909;51;90;45;0;186
25910;0;0;0;0;0
25912;94;295;90;0;479
25913;137;135;720;0;992
25914;38;45;315;0;398
25915;0;0;0;0;0
25916;95;615;270;0;980
25917;0;0;0;0;0
25918;16;67;67;0;150
25919;135;300;250;0;685
25920;40;180;135;0;355
25921;221;475;180;0;876
25922;326;585;340;0;1251
25923;82;35;128;0;245
25924;0;0;0;0;0
25926;321;1355;996;0;2672
25927;148;361;309;0;818
25928;0;0;0;0;0
25929;445;495;875;0;1815
25930;0;0;0;0;0
25931;32;0;44;0;76
25932;0;0;15;0;15
25933;74;344;45;0;463
25934;0;0;0;0;0
25935;114;270;45;0;429
25936;0;395;321;0;716
25937;24;225;90;0;339
25938;52;132;440;0;624
25940;44;704;308;0;1056
25941;77;0;44;0;121
25943;15;315;45;0;375
25944;78;255;50;0;383
25945;0;0;0;0;0
25946;0;90;0;0;90
25947;0;0;0;0;0
25948;0;0;0;0;0
25949;0;0;0;0;0
25950;4;90;117;0;211
25951;25;23;70;0;118
25952;18;225;0;0;243
25953;8;202;90;0;300
25954;110;292;45;0;447
25955;0;0;0;0;0
25957;0;0;0;0;0
25958;0;0;0;0;0
25959;0;0;0;0;0
25960;424;806;809;0;2039
25961;153;1172;450;0;1775
25962;0;0;0;0;0
25963;0;0;0;0;0
25964;124;282;44;0;450
25965;52;228;53;0;333
25966;0;45;0;0;45
25967;0;0;0;0;0
25968;0;90;45;0;135
25969;45;260;180;0;485
25970;16;105;180;0;301
25971;25;190;45;0;260
25972;24;90;90;0;204
25974;0;0;0;0;0
25976;70;458;177;0;705
25977;0;40;25;0;65
25978;10;30;0;0;40
25979;0;170;35;0;205
25980;0;0;0;0;0
25981;0;0;0;0;0
25982;0;100;35;0;135
25983;0;30;10;0;40
25984;75;140;405;0;620
25985;0;0;0;0;0
25986;0;0;0;0;0
25988;577;793;855;0;2225
25989;0;0;0;0;0
25991;175;576;315;0;1066
25992;0;0;0;0;0
25993;68;44;89;0;201
25994;141;360;135;0;636
25995;115;224;247;0;586
25996;28;145;45;0;218
25997;130;270;90;0;490
25998;43;44;35;0;122
25999;304;2067;945;0;3316
26000;0;196;0;0;196
26001;110;1323;630;0;2063
26002;0;0;0;0;0
26003;90;594;265;0;949
26004;76;44;88;0;208
26005;32;44;221;0;297
26006;36;318;160;0;514
26008;28;45;45;0;118
26009;0;0;0;0;0
26011;0;0;0;0;0
26012;462;450;495;0;1407
26013;48;315;292;0;655
26014;64;112;45;0;221
26015;84;262;90;0;436
26016;49;225;90;0;364
26017;140;135;45;0;320
26018;0;0;0;0;0
26019;149;178;180;0;507
26020;0;0;0;0;0
26021;76;509;67;0;652
26022;8;0;32;0;40
26023;0;0;0;0;0
26025;220;405;90;0;715
26026;0;0;0;0;0
26027;0;44;0;0;44
26028;0;405;135;0;540
26029;0;0;0;0;0
26030;0;0;0;0;0
26031;0;45;0;0;45
26032;0;0;26;0;26
26033;45;1125;451;0;1621
26034;0;0;0;0;0
26035;415;733;135;0;1283
26036;0;0;0;0;0
26037;549;1229;594;0;2372
26039;0;180;45;0;225
26040;0;0;0;0;0
26042;0;0;0;0;0
26043;56;90;75;0;221
26044;258;497;225;0;980
26045;90;545;135;0;770
26046;0;0;0;0;0
26047;53;45;40;0;138
26048;0;45;45;0;90
26049;0;0;0;0;0
26050;0;44;30;0;74
26051;45;90;60;0;195
26052;0;75;30;0;105
26053;90;813;280;0;1183
26054;0;47;40;0;87
26056;0;0;0;0;0
26057;0;75;60;0;135
26058;0;0;0;0;0
26059;0;0;0;0;0
26060;0;0;0;0;0
26061;0;100;64;0;164
26062;45;66;0;0;111
26063;0;35;0;0;35
26064;101;180;45;0;326
26065;0;20;0;0;20
26066;0;0;45;0;45
26067;0;0;0;0;0
26068;45;180;188;0;413
26070;4;20;0;0;24
26071;23;45;225;0;293
26073;40;45;15;0;100
26074;0;0;0;0;0
26075;120;215;360;0;695
26076;0;100;65;0;165
26077;0;15;45;0;60
26078;0;0;0;0;0
26079;0;404;45;0;449
26080;0;0;0;0;0
26081;69;44;0;0;113
26082;0;0;110;0;110
26083;283;546;470;0;1299
26084;208;562;315;0;1085
26085;0;24;40;0;64
26087;0;50;0;0;50
26088;0;90;45;0;135
26089;0;0;0;0;0
26090;125;0;130;0;255
26091;16;150;0;0;166
26092;67;392;331;0;790
26093;117;238;80;0;435
26094;152;1045;215;0;1412
26095;0;0;0;0;0
26096;0;0;0;0;0
26097;79;225;96;0;400
26098;75;256;135;0;466
26099;0;135;90;0;225
26100;24;159;45;0;228
26101;67;135;90;0;292
26102;0;36;64;0;100
26103;0;0;0;0;0
26104;24;110;45;0;179
26106;43;0;720;0;763
26107;39;135;135;0;309
26108;151;405;90;0;646
26109;0;0;0;0;0
26110;45;675;405;0;1125
26111;511;569;385;0;1465
26112;0;80;40;0;120
26113;48;0;180;0;228
26114;68;210;165;0;443
26115;139;360;90;0;589
26116;20;45;135;0;200
26117;271;552;270;0;1093
26118;0;0;0;0;0
26120;45;106;175;0;326
26121;0;61;112;0;173
26123;0;80;0;0;80
26124;0;0;0;0;0
26125;0;0;0;0;0
26126;72;317;45;0;434
26128;17;0;113;0;130
26129;0;0;90;0;90
26130;138;751;495;0;1384
26131;0;0;0;0;0
26133;0;0;0;0;0
26134;0;0;0;0;0
26135;459;1261;984;0;2704
26137;45;130;90;0;265
26138;30;0;149;0;179
26139;55;222;135;0;412
26140;32;134;90;0;256
26141;0;44;0;0;44
26142;0;220;0;0;220
26143;32;0;45;0;77
26144;24;126;45;0;195
26145;0;0;80;0;80
26146;0;0;0;0;0
26147;23;0;120;0;143
26148;48;112;92;0;252
26149;0;0;0;0;0
26150;52;404;225;0;681
26151;36;0;45;0;81
26152;44;425;155;0;624
26154;0;0;0;0;0
26155;0;0;0;0;0
26156;0;0;0;0;0
26157;58;525;270;0;853
26158;70;315;359;0;744
26159;126;201;135;0;462
26160;0;0;0;0;0
26161;0;70;20;0;90
26162;0;0;0;0;0
26163;43;135;45;0;223
26164;100;315;135;0;550
26165;0;90;30;0;120
26166;26;145;45;0;216
26168;45;180;225;0;450
26169;85;225;45;0;355
26171;0;0;0;0;0
26172;18;360;90;0;468
26173;0;0;0;0;0
26174;0;22;0;0;22
26175;6;0;25;0;31
26176;24;88;0;0;112
26177;0;0;0;0;0
26178;0;0;0;0;0
26179;0;0;0;0;0
26180;0;90;90;0;180
26181;0;0;45;0;45
26182;32;180;45;0;257
26183;8;115;0;0;123
26185;0;55;0;0;55
26186;0;0;0;0;0
26187;0;94;0;0;94
26188;0;30;0;0;30
26189;0;0;0;0;0
26190;0;0;0;0;0
26191;13;45;13;0;71
26192;0;0;0;0;0
26193;0;0;0;0;0
26194;0;40;30;0;70
26195;0;45;45;0;90
26196;0;0;0;0;0
26197;0;0;225;0;225
26199;0;0;0;0;0
26200;14;0;135;0;149
26201;0;20;0;0;20
26202;220;10;360;0;590
26204;0;45;20;0;65
26205;0;0;0;0;0
26206;0;0;0;0;0
26207;30;90;135;0;255
26208;0;90;0;0;90
26209;213;405;270;0;888
26210;0;0;0;0;0
26211;0;32;0;0;32
26212;0;45;0;0;45
26213;67;0;135;0;202
26214;15;25;50;0;90
26215;65;135;90;0;290
26216;0;0;105;0;105
26218;0;0;45;0;45
26219;127;449;260;0;836
26221;16;112;20;0;148
26222;36;305;90;0;431
26223;0;0;127;0;127
26224;40;99;360;0;499
26225;25;45;180;0;250
26226;0;45;25;0;70
26227;18;174;115;0;307
26228;0;535;180;0;715
26229;0;0;0;0;0
26230;121;135;90;0;346
26231;35;180;86;0;301
26232;0;0;0;0;0
26233;0;0;0;0;0
26235;134;290;178;0;602
26236;174;263;25;0;462
26237;88;151;225;0;464
26238;574;605;880;0;2059
26239;86;294;315;0;695
26240;24;30;200;0;254
26241;48;180;241;0;469
26242;0;0;0;0;0
26243;77;315;45;0;437
26244;32;200;192;0;424
26245;40;521;177;0;738
26246;104;246;90;0;440
26247;0;0;0;0;0
26249;58;194;90;0;342
26250;0;355;0;0;355
26252;44;270;173;0;487
26253;0;0;0;0;0
26254;155;450;180;0;785
26255;33;90;135;0;258
26256;62;0;111;0;173
26257;171;0;360;0;531
26258;0;0;73;0;73
26259;94;83;125;0;302
26260;125;1084;515;0;1724
26261;62;107;30;0;199
26262;35;135;45;0;215
26263;22;215;45;0;282
26264;40;783;175;0;998
26266;0;0;0;0;0
26267;35;45;45;0;125
26268;0;581;135;0;716
26269;339;630;180;0;1149
26270;50;225;68;0;343
26271;0;270;135;0;405
26272;127;1001;540;0;1668
26273;77;45;170;0;292
26274;197;214;498;0;909
26275;24;180;90;0;294
26276;48;278;221;0;547
26278;0;90;45;0;135
26280;0;0;25;0;25
26281;32;44;268;0;344
26283;0;0;0;0;0
26284;0;0;0;0;0
26285;0;0;0;0;0
26286;24;74;0;0;98
26287;40;90;0;0;130
26288;0;0;0;0;0
26289;18;132;45;0;195
26290;0;0;0;0;0
26291;0;0;0;0;0
26292;101;485;495;0;1081
26293;45;213;315;0;573
26294;0;0;0;0;0
26295;0;0;0;0;0
26297;0;44;0;0;44
26298;0;60;45;0;105
26299;8;135;90;0;233
26300;0;45;45;0;90
26302;0;0;0;0;0
26303;107;167;405;0;679
26304;0;44;44;0;88
26305;0;44;44;0;88
26306;0;68;0;0;68
26307;0;0;0;0;0
26308;0;0;0;0;0
26309;48;90;90;0;228
26310;0;0;90;0;90
26311;855;993;743;0;2591
26314;0;0;0;0;0
26316;52;180;90;0;322
26317;0;84;45;0;129
26318;28;52;225;0;305
26319;0;0;0;0;0
26320;24;113;0;0;137
26321;0;45;45;0;90
26322;26;90;45;0;161
26323;26;90;90;0;206
26324;76;135;315;0;526
26325;22;66;22;0;110
26326;0;0;0;0;0
26327;27;90;90;0;207
26328;0;0;0;0;0
26330;24;344;45;0;413
26331;0;0;0;0;0
26333;44;204;264;0;512
26334;101;90;45;0;236
26335;0;0;0;0;0
26336;0;0;0;0;0
26337;5;0;45;0;50
26338;0;25;0;0;25
26339;0;0;0;0;0
26340;0;45;8;0;53
26341;176;85;135;0;396
26342;20;70;60;0;150
26343;0;0;0;0;0
26344;28;113;180;0;321
26345;153;45;135;0;333
26347;73;225;114;0;412
26348;0;51;15;0;66
26349;57;297;90;0;444
26350;40;45;82;0;167
26351;16;90;45;0;151
26352;0;90;180;0;270
26353;0;0;0;0;0
26354;38;45;45;0;128
26355;38;44;105;0;187
26356;34;88;44;0;166
26357;183;270;45;0;498
26358;16;30;90;0;136
26359;0;78;199;0;277
26360;45;155;60;0;260
26361;116;308;353;0;777
26362;129;795;405;0;1329
26364;33;157;111;0;301
26365;300;730;1075;0;2105
26367;170;1075;570;0;1815
26368;157;383;305;0;845
26369;0;0;0;0;0
26370;41;45;135;0;221
26371;0;45;45;0;90
26372;571;813;443;0;1827
26373;48;365;90;0;503
26374;0;0;0;0;0
26378;0;120;270;0;390
26379;350;634;360;0;1344
26381;265;1151;570;0;1986
26382;31;125;80;0;236
26383;78;740;45;0;863
26384;44;225;180;0;449
26385;0;0;0;0;0
26386;20;70;30;0;120
26387;44;475;270;0;789
26388;24;110;99;0;233
26389;0;0;0;0;0
26390;0;0;0;0;0
26391;0;0;115;0;115
26392;0;136;90;0;226
26393;15;180;90;0;285
26395;114;135;45;0;294
26396;69;0;120;0;189
26397;14;60;90;0;164
26398;0;70;42;0;112
26399;360;475;178;0;1013
26400;0;0;0;0;0
26402;0;0;0;0;0
26403;129;327;257;0;713
26404;0;0;0;0;0
26405;44;225;0;0;269
26406;0;40;135;0;175
26407;40;30;405;0;475
26408;16;90;135;0;241
26409;26;158;45;0;229
26410;24;90;204;0;318
26411;112;225;360;0;697
26412;20;0;130;0;150
26414;16;139;90;0;245
26415;45;291;45;0;381
26416;45;537;135;0;717
26417;0;0;0;0;0
26418;0;0;0;0;0
26419;20;266;220;0;506
26420;61;47;90;0;198
26421;32;85;108;0;225
26422;214;360;585;0;1159
26423;0;0;0;0;0
26424;30;264;192;0;486
26425;0;0;0;0;0
26426;6;0;34;0;40
26428;0;0;0;0;0
26429;0;94;42;0;136
26431;0;0;0;0;0
26432;67;292;90;0;449
26434;265;134;180;0;579
26435;16;168;52;0;236
26436;831;2327;900;0;4058
26438;17;336;180;0;533
26439;16;45;45;0;106
26440;0;0;0;0;0
26441;36;45;225;0;306
26442;85;269;45;0;399
26443;32;374;45;0;451
26445;38;118;40;0;196
26446;24;160;45;0;229
26447;40;225;90;0;355
26448;15;44;63;0;122
26449;73;135;90;0;298
26450;62;315;135;0;512
26451;141;45;428;0;614
26452;0;106;0;0;106
26453;45;180;70;0;295
26454;210;585;323;0;1118
26455;44;135;180;0;359
26456;137;0;235;0;372
26457;16;90;45;0;151
26459;20;0;135;0;155
26460;0;225;90;0;315
26462;58;292;90;0;440
26463;0;0;0;0;0
26464;67;135;135;0;337
26465;0;10;45;0;55
26466;407;1045;585;0;2037
26467;0;0;0;0;0
26468;40;88;22;0;150
26469;63;270;45;0;378
26470;0;27;98;0;125
26471;61;270;45;0;376
26472;8;4;85;0;97
26473;9;114;0;0;123
26474;16;88;88;0;192
26476;45;0;0;0;45
26477;22;264;22;0;308
26478;15;44;22;0;81
26479;0;0;120;0;120
26480;59;90;0;0;149
26481;15;45;89;0;149
26482;56;173;170;0;399
26483;57;202;132;0;391
26484;65;419;342;0;826
26485;18;0;90;0;108
26486;0;0;0;0;0
26487;69;115;0;0;184
26488;0;0;0;0;0
26490;22;139;45;0;206
26491;0;0;75;0;75
26493;24;88;45;0;157
26494;20;115;45;0;180
26495;61;134;45;0;240
26496;0;249;190;0;439
26497;45;114;45;0;204
26498;16;44;66;0;126
26499;0;0;0;0;0
26500;18;108;45;0;171
26501;306;440;176;0;922
26502;0;135;45;0;180
26503;180;405;450;0;1035
26504;0;0;0;0;0
26505;0;0;0;0;0
26506;0;0;0;0;0
26507;394;172;196;0;762
26509;86;0;113;0;199
26510;30;0;88;0;118
26512;76;180;90;0;346
26513;23;0;180;0;203
26514;20;225;135;0;380
26515;0;0;0;0;0
26516;8;0;45;0;53
26517;224;0;90;0;314
26518;88;270;135;0;493
26519;12;30;45;0;87
26520;34;90;0;0;124
26521;56;225;38;0;319
26522;57;90;45;0;192
26523;0;220;135;0;355
26524;269;191;449;0;909
26526;100;135;270;0;505
26527;137;270;180;0;587
26528;18;0;67;0;85
26529;81;95;45;0;221
26530;12;0;75;0;87
26531;8;83;20;0;111
26532;183;208;45;0;436
26533;24;135;225;0;384
26534;220;135;45;0;400
26535;61;22;90;0;173
26536;35;0;130;0;165
26537;0;0;0;0;0
26538;90;3657;945;0;4692
26540;0;0;0;0;0
26541;53;315;45;0;413
26543;60;90;240;0;390
26544;24;45;255;0;324
26566;0;0;0;0;0
30001;461;205;165;0;831
30002;132;99;90;0;321
30003;177;699;90;0;966
30004;21;133;25;0;179
30005;382;1298;305;0;1985
30006;206;814;210;0;1230
30007;0;498;90;0;588
30009;15;0;175;0;190
30010;34;233;135;0;402
30012;91;135;134;0;360
30013;106;299;0;0;405
31001;0;51;38;0;89
31002;24;102;45;0;171
31003;135;225;45;0;405
31004;0;0;0;0;0
31005;60;180;90;0;330
31006;0;38;0;0;38
31007;0;0;0;0;0
31008;61;45;0;0;106
31009;16;45;89;0;150
31010;166;532;264;0;962
31011;42;0;68;0;110
31012;17;300;90;0;407
31013;0;180;0;0;180
31015;74;180;135;0;389
31016;132;279;90;0;501
31017;0;39;44;0;83
31018;0;22;0;0;22
31019;24;447;60;0;531
31020;0;214;86;0;300
31021;46;135;45;0;226
31022;8;45;25;0;78
31029;0;405;45;0;450
31030;45;714;425;0;1184
31032;85;180;90;0;355
31033;94;225;0;0;319
31034;20;25;0;0;45
31035;18;90;45;0;153
31036;131;300;165;0;596
31037;176;404;315;0;895
31038;18;89;57;0;164
31039;0;0;0;0;0
31040;45;480;215;0;740
31041;70;202;90;0;362
31042;0;85;90;0;175
31043;72;90;135;0;297
31044;12;0;22;0;34
31046;16;0;45;0;61
31047;0;0;0;0;0
31048;0;37;22;0;59
31049;26;135;45;0;206
31050;0;0;0;0;0
31051;166;315;180;0;661
31052;135;360;417;0;912
31053;0;53;45;0;98
31054;114;120;135;0;369
31055;10;135;45;0;190
31056;54;142;315;0;511
31057;0;0;0;0;0
31058;0;0;0;0;0
31060;0;88;45;0;133
31061;0;40;125;0;165
31063;32;315;90;0;437
31064;224;180;0;0;404
31065;220;264;265;0;749
31066;71;152;593;0;816
31067;0;0;0;0;0
31068;0;348;208;0;556
31069;20;264;44;0;328
31070;0;120;25;0;145
31071;66;308;135;0;509
31072;45;235;45;0;325
31073;63;90;0;0;153
31074;0;308;0;0;308
31075;17;66;67;0;150
31077;90;0;625;0;715
31078;134;352;88;0;574
31079;0;0;0;0;0
31080;96;90;0;0;186
31081;78;180;150;0;408
31082;83;45;90;0;218
31083;30;236;225;0;491
31084;133;301;90;0;524
31085;45;180;90;0;315
31086;90;512;45;0;647
31087;42;585;135;0;762
31088;36;202;90;0;328
31089;28;45;0;0;73
31090;10;255;247;0;512
31091;31;63;45;0;139
31092;15;35;0;0;50
31094;173;247;90;0;510
31095;0;30;0;0;30
31096;0;0;0;0;0
31097;50;208;168;0;426
31098;4;60;60;0;124
31099;165;90;67;0;322
31100;72;181;135;0;388
31101;0;0;0;0;0
31102;0;45;40;0;85
31103;162;308;308;0;778
31104;0;45;0;0;45
31105;24;90;90;0;204
31106;22;420;115;0;557
31107;68;147;313;0;528
31108;32;135;135;0;302
31110;171;558;225;0;954
31111;43;180;45;0;268
31113;177;495;45;0;717
31114;44;135;45;0;224
31115;32;45;269;0;346
31116;340;405;225;0;970
31117;22;176;88;0;286
31118;90;135;135;0;360
31119;45;300;130;0;475
31120;221;0;135;0;356
31121;132;479;148;0;759
31122;27;231;208;0;466
31123;19;292;180;0;491
31124;0;45;0;0;45
31125;70;226;27;0;323
31127;0;0;0;0;0
31128;44;564;704;0;1312
31129;40;45;0;0;85
31130;24;122;182;0;328
31131;0;30;0;0;30
31132;90;45;135;0;270
31133;85;45;45;0;175
31134;0;90;0;0;90
31135;24;178;45;0;247
31136;84;45;51;0;180
31137;24;224;44;0;292
31138;16;90;45;0;151
31139;37;180;90;0;307
31140;32;0;45;0;77
31141;50;0;175;0;225
31142;12;44;44;0;100
31144;95;132;44;0;271
31145;16;117;80;0;213
31146;0;0;0;0;0
31147;0;0;0;0;0
31148;9;45;0;0;54
31149;60;203;180;0;443
31150;0;225;45;0;270
31151;0;0;0;0;0
31152;86;225;0;0;311
31153;197;495;360;0;1052
31154;176;677;135;0;988
31155;24;46;180;0;250
31156;0;0;0;0;0
31158;81;405;90;0;576
31159;80;491;180;0;751
31161;618;917;438;0;1973
31162;58;0;85;0;143
31163;0;45;90;0;135
31164;77;0;225;0;302
31165;16;67;20;0;103
31166;12;45;45;0;102
31167;95;40;40;0;175
31168;40;64;77;0;181
31169;8;22;22;0;52
31170;48;0;186;0;234
31171;69;226;45;0;340
31172;33;249;30;0;312
31173;75;45;50;0;170
31175;129;180;90;0;399
31176;16;110;45;0;171
31177;20;90;30;0;140
31178;16;90;45;0;151
31179;22;90;45;0;157
31180;0;113;0;0;113
31181;0;44;0;0;44
31182;18;90;135;0;243
31183;24;90;225;0;339
31184;0;0;44;0;44
31185;70;225;90;0;385
31186;0;0;0;0;0
31187;58;35;0;0;93
31189;60;0;0;0;60
31190;166;45;90;0;301
31192;210;135;155;0;500
31193;101;270;210;0;581
31194;73;256;45;0;374
31195;0;0;0;0;0
31196;68;38;92;0;198
31197;0;0;0;0;0
31198;0;44;132;0;176
31199;87;90;288;0;465
31200;28;198;45;0;271
31201;102;90;68;0;260
31202;45;159;22;0;226
31203;60;981;180;0;1221
31204;0;0;0;0;0
31205;0;0;0;0;0
31206;69;0;225;0;294
31208;0;0;0;0;0
31209;35;135;90;0;260
31211;0;251;45;0;296
31212;18;131;85;0;234
31213;0;0;0;0;0
31214;24;113;68;0;205
31215;69;135;123;0;327
31216;27;115;0;0;142
31217;0;225;23;0;248
31218;0;153;155;0;308
31219;49;321;40;0;410
31220;44;262;265;0;571
31221;252;180;165;0;597
31222;42;0;44;0;86
31223;13;45;0;0;58
31249;32;176;44;0;252
31250;63;113;45;0;221
31251;16;88;44;0;148
31252;0;20;30;0;50
31253;138;410;318;0;866
31254;190;360;234;0;784
31256;0;50;69;0;119
31257;26;0;135;0;161
31258;0;0;0;0;0
31259;99;112;45;0;256
31260;140;310;454;0;904
31261;64;224;90;0;378
31262;0;579;225;0;804
31263;0;0;57;0;57
31264;0;177;44;0;221
31265;0;0;0;0;0
31266;196;255;90;0;541
31267;60;45;90;0;195
31268;0;190;78;0;268
31270;81;25;257;0;363
31271;0;0;0;0;0
31273;0;0;0;0;0
31274;132;450;225;0;807
31275;6;0;44;0;50
31276;35;0;0;0;35
31277;109;159;90;0;358
31278;33;135;90;0;258
31279;12;60;25;0;97
31280;16;157;45;0;218
31281;30;0;0;0;30
31282;30;180;45;0;255
31283;45;197;77;0;319
31284;0;0;0;0;0
31285;30;270;90;0;390
31287;16;100;100;0;216
31288;0;396;176;0;572
31289;0;108;32;0;140
31290;193;450;315;0;958
31291;67;134;26;0;227
31292;12;94;22;0;128
31293;0;528;315;0;843
31294;215;739;426;0;1380
31295;83;90;430;0;603
31296;0;0;0;0;0
31297;32;135;255;0;422
31298;0;0;0;0;0
31299;124;220;352;0;696
31300;0;20;20;0;40
31302;215;170;85;0;470
31303;0;61;190;0;251
31304;26;110;70;0;206
31306;61;329;90;0;480
31307;0;0;0;0;0
31308;32;74;22;0;128
31318;0;0;0;0;0
31326;28;45;45;0;118
31327;128;2122;720;0;2970
31328;0;25;10;0;35
31329;24;90;45;0;159
31330;16;44;148;0;208
31331;10;45;105;0;160
31332;0;133;80;0;213
31333;43;45;112;0;200
31334;69;135;90;0;294
31335;44;474;135;0;653
31337;185;45;224;0;454
31338;18;0;0;0;18
31339;16;0;0;0;16
31340;277;1790;630;0;2697
31341;56;247;45;0;348
31342;173;676;270;0;1119
31343;314;616;616;0;1546
31344;0;0;0;0;0
31345;321;947;616;0;1884
31346;0;0;0;0;0
31347;0;152;180;0;332
31350;148;0;45;0;193
31360;0;80;45;0;125
31361;21;90;65;0;176
31362;8;152;25;0;185
31363;51;90;90;0;231
31364;146;180;225;0;551
31365;45;137;68;0;250
31366;25;202;0;0;227
31368;0;0;75;0;75
31369;37;0;109;0;146
31371;44;180;45;0;269
31372;0;0;0;0;0
31373;0;0;0;0;0
31374;112;134;45;0;291
31375;45;90;45;0;180
31376;196;10;0;0;206
31377;56;90;315;0;461
31378;64;910;540;0;1514
31379;92;540;360;0;992
31380;28;0;135;0;163
31381;8;90;98;0;196
31382;36;45;45;0;126
31383;52;0;44;0;96
31385;0;0;0;0;0
31386;0;0;0;0;0
31387;0;0;0;0;0
31388;165;470;405;0;1040
31389;63;44;22;0;129
31390;22;90;45;0;157
31391;30;90;0;0;120
31392;45;512;243;0;800
31393;0;0;0;0;0
31394;0;225;112;0;337
31395;0;15;0;0;15
31396;69;112;45;0;226
31397;0;46;22;0;68
31405;0;0;20;0;20
31407;0;16;0;0;16
31408;0;75;0;0;75
31409;12;0;44;0;56
31412;90;0;301;0;391
31419;0;0;0;0;0
31421;73;270;135;0;478
31422;0;0;0;0;0
31423;32;90;225;0;347
31424;27;90;45;0;162
31425;0;90;225;0;315
31426;0;0;0;0;0
31427;81;270;45;0;396
31428;10;70;45;0;125
31429;0;0;0;0;0
31430;0;85;180;0;265
31431;0;452;112;0;564
31432;262;1108;315;0;1685
31433;77;94;45;0;216
31435;38;45;90;0;173
31436;13;90;0;0;103
31437;32;135;70;0;237
31438;6;0;0;0;6
31439;20;58;0;0;78
31440;104;118;40;0;262
31441;180;179;90;0;449
31442;22;94;0;0;116
31443;27;0;265;0;292
31444;0;44;0;0;44
31445;210;419;225;0;854
31446;44;294;37;0;375
31447;34;85;70;0;189
31449;24;90;53;0;167
31450;45;0;45;0;90
31452;42;135;45;0;222
31453;100;189;65;0;354
31454;0;0;0;0;0
31455;6;43;22;0;71
31456;0;273;0;0;273
31457;0;135;0;0;135
31458;22;90;135;0;247
31459;16;90;30;0;136
31460;40;135;90;0;265
31461;69;135;90;0;294
31462;42;90;45;0;177
31466;10;0;0;0;10
31486;172;69;108;0;349
31492;27;88;44;0;159
31493;0;0;45;0;45
31494;0;4;0;0;4
31495;133;405;315;0;853
31497;45;161;70;0;276
31498;22;181;45;0;248
31499;125;155;225;0;505
31500;70;250;90;0;410
31502;65;53;517;0;635
31503;16;0;110;0;126
31504;0;81;0;0;81
31505;156;176;0;0;332
31506;118;421;88;0;627
31507;16;45;75;0;136
31508;78;179;54;0;311
31509;20;90;45;0;155
32032;34;225;45;0;304
40000;0;50;0;0;50
40001;0;45;66;0;111
40006;198;1051;270;0;1519
40007;38;90;45;0;173
40008;114;45;0;0;159
40009;70;220;44;0;334
40010;24;135;45;0;204
40011;0;0;0;0;0
40012;0;0;0;0;0
40013;68;370;45;0;483
40014;45;30;60;0;135
40015;21;145;140;0;306
40016;41;0;315;0;356
40017;44;176;0;0;220
40018;96;336;0;0;432
40020;0;44;0;0;44
40021;0;0;10;0;10
40023;161;765;450;0;1376
40024;64;132;132;0;328
40025;159;545;308;0;1012
40026;0;0;0;0;0
40027;115;365;360;0;840
40028;26;193;135;0;354
40029;79;264;132;0;475
40030;2;148;30;0;180
40031;0;0;0;0;0
40032;0;0;0;0;0
40033;30;380;90;0;500
40034;35;201;135;0;371
40035;92;138;88;0;318
40037;0;45;209;0;254
40038;75;500;135;0;710
40039;0;0;0;0;0
40041;0;0;0;0;0
40042;36;585;45;0;666
40043;0;80;90;0;170
40044;0;0;0;0;0
40045;17;145;45;0;207
40046;0;0;0;0;0
40047;136;337;0;0;473
40048;40;178;45;0;263
40049;24;0;87;0;111
40050;10;20;0;0;30
40051;45;180;90;0;315
40052;67;81;170;0;318
40054;234;389;135;0;758
40055;120;180;45;0;345
40056;69;270;155;0;494
40057;0;45;45;0;90
40058;0;20;85;0;105
40059;0;22;0;0;22
40060;0;0;0;0;0
40061;33;180;75;0;288
40062;37;217;60;0;314
40063;24;0;287;0;311
40064;182;250;230;0;662
40065;10;117;90;0;217
40066;0;0;115;0;115
40068;64;177;44;0;285
40069;0;0;0;0;0
40071;25;75;94;0;194
40072;0;0;0;0;0
40073;147;459;90;0;696
40074;27;235;25;0;287
40075;0;0;0;0;0
40076;194;175;45;0;414
40077;0;0;0;0;0
40078;294;581;176;0;1051
40079;0;180;45;0;225
40080;335;1046;300;0;1681
40081;7;40;10;0;57
40082;39;115;45;0;199
40083;126;256;54;0;436
40085;0;114;89;0;203
40086;0;0;0;0;0
40089;23;157;45;0;225
40090;29;292;135;0;456
40092;19;0;180;0;199
40093;0;83;90;0;173
40094;0;0;0;0;0
40095;54;0;33;0;87
40097;0;0;0;0;0
40099;114;282;188;0;584
40101;159;180;260;0;599
40102;0;90;278;0;368
40104;0;0;0;0;0
40105;0;45;0;0;45
40106;40;345;135;0;520
40107;27;180;157;0;364
40108;0;0;0;0;0
40109;0;0;0;0;0
40110;20;1204;215;0;1439
40111;14;195;0;0;209
40112;0;0;0;0;0
40113;52;123;0;0;175
40114;96;610;484;0;1190
40115;105;12;45;0;162
40116;0;26;20;0;46
40119;32;225;67;0;324
40121;25;120;135;0;280
40122;24;180;0;0;204
40123;23;0;180;0;203
40124;77;180;275;0;532
40125;0;0;0;0;0
40126;136;880;489;0;1505
40127;67;180;22;0;269
40129;0;0;0;0;0
40130;128;323;90;0;541
40132;35;185;45;0;265
40133;0;0;0;0;0
40135;104;45;45;0;194
40136;16;112;22;0;150
40137;84;335;90;0;509
40138;32;246;76;0;354
40139;0;0;0;0;0
40140;42;273;120;0;435
40141;18;176;176;0;370
40142;152;0;270;0;422
40143;24;90;115;0;229
40144;0;20;0;0;20
40145;71;172;35;0;278
40146;164;366;90;0;620
40147;0;0;0;0;0
40149;22;90;90;0;202
40150;45;180;58;0;283
40152;0;7;0;0;7
40153;0;72;0;0;72
40154;28;210;45;0;283
40155;12;540;180;0;732
40156;0;0;0;0;0
40157;22;45;90;0;157
40158;15;0;73;0;88
40159;25;155;90;0;270
40160;103;44;60;0;207
40161;0;0;0;0;0
40163;24;132;40;0;196
40164;0;0;0;0;0
40166;0;0;0;0;0
40167;117;177;90;0;384
40168;52;178;90;0;320
40169;42;136;24;0;202
40170;73;164;0;0;237
40171;90;161;45;0;296
40172;47;292;203;0;542
40173;0;347;135;0;482
40174;149;270;207;0;626
40175;0;0;0;0;0
40176;38;82;90;0;210
40177;53;202;90;0;345
40178;29;180;45;0;254
40180;0;0;0;0;0
40181;0;132;0;0;132
40183;0;0;0;0;0
40184;49;280;225;0;554
40185;0;0;0;0;0
40186;116;45;74;0;235
40187;0;25;0;0;25
40189;187;0;90;0;277
40190;25;135;25;0;185
40191;5;0;100;0;105
40192;66;0;315;0;381
40193;70;277;270;0;617
40194;140;950;360;0;1450
40195;77;90;45;0;212
40197;0;295;0;0;295
40198;0;0;0;0;0
40199;0;0;0;0;0
40200;0;0;0;0;0
40202;0;0;0;0;0
40203;0;76;60;0;136
40204;0;0;0;0;0
40205;135;390;135;0;660
40206;69;86;40;0;195
40207;62;135;45;0;242
40208;43;180;90;0;313
40209;45;225;204;0;474
40210;114;90;45;0;249
40211;0;0;0;0;0
40212;16;125;30;0;171
40213;0;20;67;0;87
40216;34;351;58;0;443
40217;33;44;45;0;122
40218;32;140;0;0;172
40219;0;158;45;0;203
40225;0;210;45;0;255
40226;37;252;45;0;334
40228;0;0;0;0;0
40230;213;967;260;0;1440
40231;225;256;177;0;658
40233;0;27;45;0;72
40234;0;0;45;0;45
40235;20;133;78;0;231
40236;64;180;45;0;289
40237;28;89;135;0;252
40238;0;0;0;0;0
40239;0;0;0;0;0
40240;23;180;22;0;225
40241;30;192;84;0;306
40242;0;264;118;0;382
40243;27;89;67;0;183
40244;12;100;70;0;182
40245;68;176;45;0;289
40247;171;397;179;0;747
40248;25;406;90;0;521
40249;0;0;0;0;0
40250;0;0;0;0;0
40251;44;368;519;0;931
40252;30;400;270;0;700
40253;69;495;90;0;654
40254;0;33;0;0;33
40255;118;180;90;0;388
40256;328;933;625;0;1886
40257;57;225;135;0;417
40258;0;0;0;0;0
40259;94;180;45;0;319
40260;0;0;0;0;0
40261;47;206;50;0;303
40262;44;136;45;0;225
40264;0;0;0;0;0
40265;0;0;22;0;22
40266;17;45;45;0;107
40267;66;203;145;0;414
40268;0;80;0;0;80
40269;0;0;0;0;0
40270;44;495;45;0;584
40271;35;165;0;0;200
40272;45;45;0;0;90
40273;76;160;108;0;344
40274;0;0;0;0;0
40275;22;45;270;0;337
40276;16;180;90;0;286
40278;72;427;180;0;679
40279;8;0;90;0;98
40281;200;315;195;0;710
40282;44;88;69;0;201
40283;16;90;18;0;124
40284;225;495;135;0;855
40285;45;403;180;0;628
40286;0;0;0;0;0
40287;42;255;45;0;342
40288;82;194;75;0;351
40289;162;176;88;0;426
40290;0;0;0;0;0
40291;110;546;337;0;993
40292;0;0;0;0;0
40293;25;0;135;0;160
40295;178;649;315;0;1142
40296;112;114;165;0;391
40297;0;445;45;0;490
40298;333;712;215;0;1260
40299;105;440;140;0;685
40300;92;270;45;0;407
40301;282;530;342;0;1154
40302;14;90;0;0;104
40303;22;179;45;0;246
40304;0;0;0;0;0
40305;120;384;270;0;774
40307;12;45;0;0;57
40308;69;0;125;0;194
40309;16;90;135;0;241
40310;242;605;180;0;1027
40311;0;90;0;0;90
40312;30;45;180;0;255
40314;0;0;0;0;0
40315;129;199;44;0;372
40316;45;490;225;0;760
40317;98;945;315;0;1358
40318;109;135;180;0;424
40319;198;268;920;0;1386
40320;112;405;405;0;922
40321;25;25;0;0;50
40322;109;270;180;0;559
40323;0;0;0;0;0
40324;63;157;90;0;310
40325;220;176;44;0;440
40326;0;0;0;0;0
40328;46;315;75;0;436
40329;18;785;210;0;1013
40331;44;0;20;0;64
40332;10;0;78;0;88
40333;59;45;180;0;284
40334;6;0;0;0;6
40335;52;0;30;0;82
40336;0;0;0;0;0
40337;0;0;0;0;0
40338;0;50;25;0;75
40340;50;440;220;0;710
40341;0;228;0;0;228
40342;0;163;75;0;238
40343;96;453;263;0;812
40348;40;176;0;0;216
40350;0;0;0;0;0
40351;265;676;288;0;1229
40352;206;44;201;0;451
40353;57;132;130;0;319
40354;0;0;0;0;0
40359;33;224;155;0;412
40360;188;310;0;0;498
40362;0;0;44;0;44
40363;0;0;0;0;0
40364;9;45;0;0;54
40365;18;90;0;0;108
40366;224;45;35;0;304
40367;16;176;67;0;259
40368;20;166;89;0;275
40369;83;384;132;0;599
40370;45;384;270;0;699
40371;80;316;360;0;756
40372;20;44;29;0;93
40373;45;0;45;0;90
40374;0;45;10;0;55
40377;118;45;68;0;231
40378;27;90;45;0;162
40379;65;180;45;0;290
40380;30;180;45;0;255
40381;0;25;25;0;50
40382;48;90;95;0;233
40383;146;675;352;0;1173
40384;81;0;604;0;685
40385;24;135;75;0;234
40386;15;0;117;0;132
40387;0;220;45;0;265
40388;18;90;0;0;108
40390;0;20;0;0;20
40391;27;180;23;0;230
40393;0;0;0;0;0
40394;43;82;0;0;125
40395;20;489;80;0;589
40396;0;0;0;0;0
40397;43;200;67;0;310
40398;74;195;45;0;314
40399;290;1380;390;0;2060
40400;72;45;9;0;126
40401;0;283;7;0;290
40402;0;0;0;0;0
40403;147;277;135;0;559
40404;0;60;0;0;60
40405;40;135;30;0;205
40406;128;40;89;0;257
40407;44;106;45;0;195
40409;113;221;133;0;467
40410;81;233;45;0;359
40412;64;180;65;0;309
40413;36;120;229;0;385
40414;170;80;90;0;340
40415;68;221;21;0;310
40416;15;0;80;0;95
40417;67;180;90;0;337
40418;0;40;45;0;85
40419;44;0;125;0;169
40420;24;90;45;0;159
40421;19;45;90;0;154
40422;102;2213;90;0;2405
40423;60;380;45;0;485
40424;0;117;0;0;117
40426;0;0;0;0;0
40427;16;87;91;0;194
40428;16;0;115;0;131
40429;0;362;488;0;850
40430;0;52;45;0;97
40431;8;0;104;0;112
40432;0;0;0;0;0
40433;54;199;88;0;341
40434;0;0;0;0;0
40435;0;45;0;0;45
40436;0;280;180;0;460
40437;0;0;0;0;0
40438;0;0;0;0;0
40444;171;157;0;0;328
40445;29;224;0;0;253
40446;0;0;0;0;0
40447;40;20;45;0;105
40450;0;0;0;0;0
40451;38;225;25;0;288
40452;16;90;45;0;151
40453;0;108;45;0;153
40454;0;0;0;0;0
40455;55;67;0;0;122
40457;45;210;45;0;300
40458;25;90;175;0;290
40459;16;292;0;0;308
41001;0;0;0;0;0
